13
19
1
1
0
0
0
0
9
0
5
30
15
10 10 10 10 10 10 10 10 10 10 10 10 10
10 10 10 10 10 10 10 10 10 10 10 10 10
10 10 10 10 10 10 10 10 10 10 10 10 10
8 8 8 8 8 8 8 8 8 8 8 8 8
8 0 7 6 8 5 4 3 8 2 1 0 8
8 0 7 6 8 5 4 3 8 2 1 0 8
8 0 7 6 8 5 4 3 8 2 1 0 8
8 0 7 6 8 5 4 3 8 2 1 0 8
8 0 7 6 8 5 4 3 8 2 1 0 8
8 0 7 6 8 5 4 3 8 2 1 0 8
8 0 7 6 8 5 4 3 8 2 1 0 8
8 8 8 8 8 8 8 8 8 8 8 8 8
10 10 10 10 10 10 10 10 10 10 10 10 10
10 10 10 10 10 10 10 10 10 10 10 10 10
10 10 10 10 10 10 10 10 10 10 10 10 10
10 10 10 10 10 10 10 10 10 10 10 10 10
10 10 10 10 10 10 10 10 10 10 10 10 10
10 10 10 10 10 10 10 10 10 10 10 10 10
10 10 10 10 10 10 10 10 10 10 10 10 10
0 0 0 0 0 0 0 0 0 0 0 0 0
0 0 0 0 0 0 0 0 0 0 0 0 0
0 0 0 0 0 0 0 0 0 0 0 0 0
0 0 0 0 0 0 0 0 0 0 0 0 0
0 0 0 0 0 0 0 1 0 0 1 0 0
0 0 0 0 0 0 7 0 0 3 0 0 0
5 4 0 0 0 0 0 0 0 0 0 0 0
0 0 7 0 0 4 0 0 1 0 0 0 0
0 0 4 0 4 0 0 0 0 0 5 0 0
0 0 0 0 0 0 0 0 0 0 0 0 0
0 2 0 0 0 0 0 0 0 0 0 0 0
0 0 0 0 4 0 0 2 0 0 0 0 0
0 0 0 0 0 0 0 0 0 0 0 0 0
0 0 0 0 0 0 0 0 0 0 0 0 0
0 0 0 0 0 0 0 0 0 0 0 0 0
0 0 0 0 0 0 0 0 0 0 0 0 0
0 0 0 0 0 0 0 0 0 0 0 0 0
0 0 0 0 0 0 0 0 0 0 0 0 0
0 0 0 0 0 0 0 0 0 0 0 0 0
0 0 0 0 0 0 0 0 0 0 0 0 0
0 0 0 0 0 0 0 0 0 0 0 0 0
0 0 0 0 0 0 0 0 0 0 0 0 0
0 0 0 0 0 0 0 0 0 0 0 0 0
0 0 0 0 0 0 0 2 0 0 1 0 0
0 0 0 0 0 0 2 0 0 2 0 0 0
8 2 0 0 0 0 0 0 0 0 0 0 0
0 0 1 0 0 15 0 0 12 0 0 0 0
0 0 3 0 15 0 0 0 0 0 9 0 0
0 0 0 0 0 0 0 0 0 0 0 0 0
0 8 0 0 0 0 0 0 0 0 0 0 0
0 0 0 0 15 0 0 15 0 0 0 0 0
0 0 0 0 0 0 0 0 0 0 0 0 0
0 0 0 0 0 0 0 0 0 0 0 0 0
0 0 0 0 0 0 0 0 0 0 0 0 0
0 0 0 0 0 0 0 0 0 0 0 0 0
0 0 0 0 0 0 0 0 0 0 0 0 0
0 0 0 0 0 0 0 0 0 0 0 0 0
0 0 0 0 0 0 0 0 0 0 0 0 0
