13
19
1
1
1
0
1
0
2
1
5
30
15
10 10 10 10 10 10 10 10 10 10 10 10 10
10 10 10 10 10 10 10 10 10 10 10 10 10
10 10 10 10 10 10 10 10 10 10 10 4 10
10 10 10 10 10 10 10 10 4 4 4 10 10
10 10 10 10 1 1 1 1 1 4 10 10 10
10 10 10 1 1 1 1 1 1 1 4 10 10
10 10 1 1 1 1 1 1 1 1 1 10 10
10 1 1 1 1 1 1 1 1 6 6 10 10
10 1 1 1 1 1 1 1 6 6 6 6 10
10 1 1 1 1 1 1 6 6 6 6 6 10
10 1 9 1 9 1 1 6 6 6 6 6 10
10 1 9 1 9 1 1 6 6 6 6 6 10
10 1 9 1 9 1 1 6 6 6 6 10 10
10 1 1 1 1 1 1 1 6 6 6 10 10
10 1 1 1 1 1 1 1 6 6 10 10 10
10 10 1 1 1 1 1 1 1 1 10 10 10
10 10 10 4 4 10 10 4 4 4 10 10 10
10 4 4 4 4 10 10 4 4 4 4 4 10
10 10 10 10 10 10 10 10 10 10 10 10 10
0 0 0 0 0 0 0 0 0 0 0 0 0
0 0 0 0 0 0 0 0 0 0 0 0 0
0 0 0 0 0 0 0 0 0 0 0 0 0
0 0 0 0 0 0 0 0 0 0 4 0 0
0 0 0 0 0 0 0 0 0 0 0 0 0
0 0 0 0 0 0 0 0 0 0 4 0 0
0 0 0 0 7 0 0 5 0 3 0 0 0
0 0 0 0 0 0 3 0 0 0 0 0 0
0 0 0 0 0 0 0 0 0 0 0 0 0
0 0 0 0 0 0 0 0 0 5 0 0 0
0 0 0 0 0 0 0 0 0 0 6 0 0
0 0 0 0 0 0 0 0 0 0 0 0 0
0 0 0 0 0 0 0 0 0 0 0 0 0
0 0 6 0 0 6 7 0 0 0 0 0 0
0 0 0 0 0 5 0 0 0 0 0 0 0
0 0 0 0 0 3 0 0 0 0 0 0 0
0 0 0 0 0 0 0 0 0 0 0 0 0
0 0 0 0 1 0 0 0 0 0 0 0 0
0 0 0 0 0 0 0 0 0 0 0 0 0
0 0 0 0 0 0 0 0 0 0 0 0 0
0 0 0 0 0 0 0 0 0 0 0 0 0
0 0 0 0 0 0 0 0 0 0 0 0 0
0 0 0 0 0 0 0 0 0 0 5 0 0
0 0 0 0 0 0 0 0 0 3 0 0 0
0 0 0 0 0 0 0 0 0 0 2 0 0
0 0 0 0 6 0 0 6 0 8 0 0 0
0 0 0 0 0 0 8 0 0 0 0 0 0
0 0 0 0 0 0 0 0 0 0 0 0 0
0 0 0 0 0 0 0 0 0 11 0 0 0
0 0 0 0 0 0 0 0 0 0 8 0 0
0 0 0 0 0 0 0 0 0 0 0 0 0
0 0 0 0 0 0 0 0 0 0 0 0 0
0 0 1 0 0 5 12 0 0 0 0 0 0
0 0 0 0 0 0 0 0 0 0 0 0 0
0 0 0 0 0 2 0 0 0 0 0 0 0
0 0 0 0 0 0 0 0 0 0 0 0 0
0 0 0 0 2 0 0 0 0 0 0 0 0
0 0 0 0 0 0 0 0 0 0 0 0 0
