13
19
1
1
0
0
0
0
8
3
5
30
15
10 19 10 10 10 10 10 10 10 10 10 10 10
10 19 10 10 10 10 10 10 10 10 10 10 10
10 19 10 10 10 10 10 10 10 10 10 10 10
10 19 10 7 6 5 4 10 3 2 1 0 10
10 19 10 6 5 4 3 10 2 1 0 7 10
10 19 10 5 4 3 2 10 1 0 7 6 10
10 19 10 4 3 2 1 10 0 7 6 5 10
10 19 10 10 10 10 10 10 10 10 10 10 10
10 19 8 8 8 10 8 8 8 8 8 8 8
10 10 10 10 10 10 10 10 10 10 10 10 10
10 19 8 8 8 8 8 8 8 8 8 8 8
10 19 10 10 10 10 10 10 10 10 10 10 10
10 19 10 1 2 3 4 10 5 6 7 0 10
10 19 10 2 3 4 5 10 6 7 0 1 10
10 19 10 3 4 5 6 10 7 0 1 2 10
10 19 10 4 5 6 7 10 0 1 2 3 10
10 19 10 10 10 10 10 10 10 10 10 10 10
10 19 19 19 19 19 19 19 19 19 19 19 19
10 10 10 10 10 10 10 10 10 10 10 10 10
0 0 0 0 0 0 0 0 0 0 0 0 0
0 4 0 0 0 0 0 0 0 0 0 0 0
0 0 0 0 0 0 0 0 0 0 0 0 0
0 0 0 0 4 0 0 0 0 0 0 0 0
0 0 0 4 0 0 0 0 0 3 0 2 0
0 0 0 0 0 0 0 0 0 0 0 0 0
0 0 0 0 0 0 0 0 0 0 0 0 0
0 0 0 0 0 0 0 0 0 0 0 0 0
0 4 0 0 1 0 0 0 0 0 0 0 0
0 0 0 0 0 0 0 0 0 0 0 0 0
0 0 0 5 0 0 0 0 0 0 0 0 0
0 0 0 0 0 0 0 0 0 0 0 0 0
0 0 0 0 0 0 0 0 0 0 3 5 0
0 0 0 0 4 0 0 0 0 0 0 0 0
0 0 0 0 0 3 0 0 0 4 0 0 0
0 0 0 0 5 0 0 0 0 0 0 0 0
0 0 0 0 0 0 0 0 0 0 0 0 0
0 0 0 0 0 0 0 0 5 0 0 0 0
0 0 0 0 0 0 0 0 0 0 0 0 0
0 0 0 0 0 0 0 0 0 0 0 0 0
0 1 0 0 0 0 0 0 0 0 0 0 0
0 0 0 0 0 0 0 0 0 0 0 0 0
0 0 0 0 3 0 0 0 0 0 0 0 0
0 0 0 15 0 0 0 0 0 5 0 9 0
0 0 0 0 0 0 0 0 0 0 0 0 0
0 0 0 0 0 2 0 0 0 0 0 0 0
0 0 0 0 0 0 0 0 0 0 0 0 0
0 14 0 0 3 0 0 0 0 0 0 0 0
0 0 0 0 0 0 0 0 0 0 0 0 0
0 0 0 13 0 0 0 0 0 0 0 0 0
0 0 0 0 0 0 0 0 0 0 0 0 0
0 0 0 0 0 0 0 0 0 8 5 6 0
0 0 0 0 11 0 0 0 0 0 0 0 0
0 0 0 0 0 13 0 0 0 8 0 0 0
0 0 0 0 0 0 0 0 0 0 0 0 0
0 0 0 0 0 0 0 0 0 0 0 0 0
0 0 0 0 0 0 0 0 4 0 0 0 0
0 0 0 0 0 0 0 0 0 0 0 0 0
