13
19
1
1
0
0
0
0
3
1
5
30
15
10 10 10 10 10 10 10 10 10 10 10 10 10
10 10 10 10 10 10 10 10 10 10 10 10 10
10 10 10 10 10 10 10 10 10 10 10 10 10
8 3 3 3 8 10 10 10 8 4 4 4 8
8 3 3 3 8 10 10 10 8 4 4 4 8
10 8 3 8 10 10 10 10 10 8 4 8 10
10 8 3 8 10 10 10 10 10 8 4 8 10
10 10 8 10 10 10 10 10 10 10 8 10 10
10 10 8 10 8 5 5 5 8 10 8 10 10
10 10 10 10 8 5 5 5 8 10 10 10 10
10 10 10 10 10 8 5 8 10 10 10 10 10
10 10 10 10 10 8 5 8 10 10 10 10 10
10 10 10 10 10 10 8 10 10 10 10 10 10
8 6 6 6 8 10 8 10 8 7 7 7 8
8 6 6 6 8 10 10 10 8 7 7 7 8
10 8 6 8 10 10 10 10 10 8 7 8 10
10 8 6 8 10 10 10 10 10 8 7 8 10
10 10 8 10 10 10 10 10 10 10 8 10 10
10 10 8 10 10 10 10 10 10 10 8 10 10
0 0 0 0 0 0 0 0 0 0 0 0 0
0 0 0 0 0 0 0 0 0 0 0 0 0
0 0 0 0 0 0 0 0 0 0 0 0 0
0 0 0 0 0 0 0 0 0 0 0 0 0
0 4 0 0 0 0 0 0 0 5 0 0 0
0 0 0 0 0 0 0 0 0 0 0 0 0
0 0 0 0 0 0 0 0 0 5 0 0 0
0 0 0 0 0 0 0 0 0 0 5 0 0
0 0 0 0 0 0 1 0 0 0 0 0 0
0 0 0 0 7 0 0 0 0 0 0 0 0
0 0 0 0 0 0 2 0 0 0 0 0 0
0 0 0 0 0 0 0 0 0 0 0 0 0
0 0 0 0 0 0 0 0 0 0 0 0 0
0 0 0 0 0 0 4 0 0 7 0 0 0
0 0 0 0 0 0 0 0 0 0 0 1 0
0 0 5 0 0 0 0 0 0 0 0 0 0
0 3 0 0 0 0 0 0 0 0 1 0 0
0 0 0 0 0 0 0 0 0 0 0 0 0
0 0 0 0 0 0 0 0 0 0 0 0 0
0 0 0 0 0 0 0 0 0 0 0 0 0
0 0 0 0 0 0 0 0 0 0 0 0 0
0 0 0 0 0 0 0 0 0 0 0 0 0
12 0 0 0 0 0 0 0 0 0 0 0 0
0 7 0 0 0 0 0 0 0 7 0 0 0
0 0 0 0 0 0 0 0 0 0 0 0 0
0 0 0 0 0 0 0 0 0 2 0 0 0
0 0 0 0 0 0 0 0 0 0 13 0 0
0 0 0 0 0 0 9 0 0 0 0 0 0
0 0 0 0 11 0 0 0 0 0 0 0 0
0 0 0 0 0 0 7 0 0 0 0 0 0
0 0 0 0 0 0 0 0 0 0 0 0 0
0 0 0 0 0 0 0 0 0 0 0 0 0
0 0 0 0 0 0 15 0 0 12 0 0 0
0 0 0 0 0 0 0 0 0 0 0 13 0
0 0 15 0 0 0 0 0 0 0 0 0 0
0 8 0 0 0 0 0 0 0 0 14 0 0
0 0 0 0 0 0 0 0 0 0 0 0 0
0 0 0 0 0 0 0 0 0 0 0 0 0
