13
19
1
1
0
0
0
0
8
3
5
30
15
10 10 10 10 10 10 10 10 10 10 10 10 10
10 10 10 10 10 10 10 10 10 10 10 10 10
10 10 10 19 10 19 0 19 10 19 10 10 10
10 19 10 10 10 10 10 10 10 10 10 19 10
10 19 19 10 19 10 7 10 19 10 19 19 10
10 10 10 10 10 10 10 10 10 10 10 10 10
10 19 10 10 10 19 6 19 10 10 10 19 10
10 10 10 19 10 10 10 10 10 19 10 10 10
10 10 10 10 10 10 5 10 10 10 10 10 10
10 10 10 19 10 10 10 10 10 19 10 10 10
10 19 10 10 10 19 4 19 10 10 10 19 10
10 10 10 10 10 10 10 10 10 10 10 10 10
10 19 19 10 19 10 3 10 19 10 19 19 10
10 19 10 10 10 10 10 10 10 10 10 19 10
10 10 10 19 10 19 8 19 10 19 10 10 10
10 10 10 10 10 10 10 10 10 10 10 10 10
10 10 10 10 10 10 10 10 10 10 10 10 10
10 10 10 10 10 10 10 10 10 10 10 10 10
10 10 10 10 10 10 10 10 10 10 10 10 10
0 0 0 0 0 0 0 0 0 0 0 0 0
0 0 0 0 0 0 0 0 0 0 0 0 0
0 0 0 0 0 0 0 3 0 7 0 0 0
0 0 0 0 0 0 0 0 0 0 0 0 0
0 0 0 0 0 0 3 0 6 0 6 5 0
0 0 0 0 0 0 0 0 0 0 0 0 0
0 0 0 0 0 0 1 7 0 0 0 0 0
0 0 0 0 0 0 0 0 0 0 0 0 0
0 0 0 0 0 0 0 0 0 0 0 0 0
0 0 0 0 0 0 0 0 0 0 0 0 0
0 0 0 0 0 0 0 0 0 0 0 0 0
0 0 0 0 0 0 0 0 0 0 0 0 0
0 0 0 0 5 0 6 0 0 0 0 0 0
0 0 0 0 0 0 0 0 0 0 0 0 0
0 0 0 0 0 0 0 0 0 0 0 0 0
0 0 0 0 0 0 0 0 0 0 0 0 0
0 0 0 0 0 0 0 0 0 0 0 0 0
0 0 0 0 0 0 0 0 0 0 0 0 0
0 0 0 0 0 0 0 0 0 0 0 0 0
0 0 0 0 0 0 0 0 0 0 0 0 0
0 0 0 0 0 0 0 0 0 0 0 0 0
0 0 0 6 0 0 12 13 0 13 0 0 0
0 0 0 0 0 0 0 0 0 0 0 0 0
0 0 0 0 0 0 14 0 10 0 5 11 0
0 0 0 0 0 0 0 0 0 0 0 0 0
0 0 0 0 0 0 6 0 0 0 0 0 0
0 0 0 0 0 0 0 0 0 0 0 0 0
0 0 0 0 0 0 0 0 0 0 0 0 0
0 0 0 0 0 0 0 0 0 0 0 0 0
0 0 0 0 0 0 0 0 0 0 0 0 0
0 0 0 0 0 0 0 0 0 0 0 0 0
0 0 0 0 11 0 13 0 14 0 7 0 0
0 0 0 0 0 0 0 0 0 0 0 0 0
0 0 0 0 0 0 0 0 0 0 0 0 0
0 0 0 0 0 0 0 0 0 0 0 0 0
0 0 0 0 0 0 0 0 0 0 0 0 0
0 0 0 0 0 0 0 0 0 0 0 0 0
0 0 0 0 0 0 0 0 0 0 0 0 0
