13
19
1
1
0
0
0
0
7
2
5
30
15
10 10 10 10 10 10 10 10 10 10 10 10 10
10 10 10 10 10 10 10 10 10 10 10 10 10
10 10 10 10 10 10 10 10 10 10 10 10 10
10 10 10 10 10 10 10 10 10 10 10 10 10
0 7 6 5 4 3 2 1 0 7 6 5 4
1 0 7 6 5 4 3 2 1 0 7 6 5
10 10 10 10 10 10 10 10 10 10 10 10 10
10 10 10 10 10 10 10 10 10 10 10 10 10
9 9 9 9 9 8 10 8 9 9 9 9 9
9 10 10 10 10 8 10 8 10 10 10 10 10
9 10 10 10 10 8 10 8 10 10 10 10 10
9 10 0 7 10 8 10 8 10 0 7 10 10
9 10 6 5 10 8 10 8 10 6 5 10 10
9 10 10 10 10 8 10 8 10 10 10 10 10
9 10 10 10 10 8 10 8 10 10 10 10 10
9 9 9 9 9 9 8 9 9 9 9 9 9
10 10 10 10 10 10 10 10 10 10 10 10 10
10 10 10 10 10 10 10 10 10 10 10 10 10
10 10 10 10 10 10 10 10 10 10 10 10 10
0 0 0 0 0 0 0 0 0 0 0 0 0
0 0 0 0 0 0 0 0 0 0 0 0 0
0 0 0 0 0 0 0 0 0 0 0 0 0
0 0 0 0 0 0 0 0 0 0 0 0 0
0 2 0 0 0 0 0 0 0 1 0 0 0
7 0 7 0 4 3 2 0 0 0 0 0 0
0 0 0 0 0 0 0 0 0 0 0 0 0
0 0 0 0 0 0 0 0 0 0 0 0 0
0 1 0 0 0 4 0 5 1 0 4 0 0
0 0 0 0 0 2 0 7 0 0 0 0 0
0 0 0 0 0 2 0 3 0 0 0 0 0
0 0 0 6 0 0 0 0 0 6 0 0 0
0 0 0 0 0 3 0 0 0 0 0 0 0
0 0 0 0 0 0 0 0 0 0 0 0 0
0 0 0 0 0 0 0 0 0 0 0 0 0
0 0 0 5 0 7 0 0 0 0 0 4 0
0 0 0 0 0 0 0 0 0 0 0 0 0
0 0 0 0 0 0 0 0 0 0 0 0 0
0 0 0 0 0 0 0 0 0 0 0 0 0
0 0 0 0 0 0 0 0 0 0 0 0 0
0 0 0 0 0 0 0 0 0 0 0 0 0
0 0 0 0 0 0 0 0 0 0 0 0 0
0 0 0 0 0 0 0 0 0 0 0 0 0
0 1 0 0 0 0 0 0 0 8 0 0 0
6 0 1 0 13 6 14 0 0 0 0 8 0
0 0 0 0 0 0 0 0 0 0 0 0 0
0 0 0 0 0 0 0 0 0 0 0 0 0
0 5 0 0 0 2 0 9 6 0 1 0 0
0 0 0 0 0 7 0 13 0 0 0 0 0
0 0 0 0 0 14 0 3 0 0 0 0 0
0 0 0 0 0 0 0 0 0 1 0 0 0
0 0 0 0 0 5 0 0 0 4 0 0 0
0 0 0 0 0 0 0 0 0 0 0 0 0
0 0 0 0 0 0 0 0 0 0 0 0 0
0 0 0 7 0 14 0 0 0 0 0 13 0
0 0 0 0 0 0 0 0 0 0 0 0 0
0 0 0 0 0 0 0 0 0 0 0 0 0
0 0 0 0 0 0 0 0 0 0 0 0 0
