13
19
1
1
0
0
0
0
3
1
5
30
15
10 10 10 10 10 10 10 10 10 10 10 10 10
10 10 10 10 10 10 10 10 10 10 10 10 10
10 10 10 10 10 10 10 10 10 10 10 10 10
10 10 10 10 10 10 10 10 10 10 10 10 10
10 8 8 8 8 8 8 8 8 8 8 8 10
10 8 10 10 10 10 10 10 10 10 10 8 10
10 8 10 10 10 10 10 10 10 10 10 8 10
10 8 10 10 10 10 0 10 10 10 10 8 10
10 8 10 10 10 6 7 0 10 10 10 8 10
10 8 10 10 4 5 6 7 0 10 10 8 10
10 8 10 2 3 4 5 6 7 0 10 8 10
10 8 10 9 2 3 4 5 6 9 10 8 10
10 8 10 10 9 2 3 4 9 10 10 8 10
10 8 8 10 10 9 2 9 10 10 8 8 10
10 8 8 8 10 10 9 10 10 8 8 8 10
10 8 10 8 8 10 10 10 8 8 10 8 10
10 8 10 10 8 8 10 10 8 10 10 8 10
10 8 8 8 8 8 8 8 8 8 8 8 10
10 10 10 10 10 10 10 10 10 10 10 10 10
0 0 0 0 0 0 0 0 0 0 0 0 0
0 0 0 0 0 0 0 0 0 0 0 0 0
0 0 0 0 0 0 0 0 0 0 0 0 0
0 0 0 0 0 0 0 0 0 0 0 0 0
0 0 7 0 0 0 0 0 7 0 0 0 0
0 0 0 0 0 0 0 0 0 0 0 0 0
0 0 0 0 0 0 0 0 0 0 0 0 0
0 0 0 0 0 0 0 0 0 0 0 0 0
0 0 0 0 0 0 0 0 0 0 0 0 0
0 2 0 0 0 0 0 0 0 0 0 0 0
0 0 0 0 6 0 0 0 7 0 0 0 0
0 0 0 1 0 0 0 0 0 0 0 0 0
0 0 0 0 0 0 0 0 0 0 0 0 0
0 0 0 0 0 6 0 0 0 0 0 0 0
0 6 0 0 0 0 0 0 0 0 0 3 0
0 0 0 0 5 0 0 0 0 0 0 0 0
0 0 0 0 0 0 0 0 0 0 0 0 0
0 0 0 2 0 0 0 0 0 0 0 0 0
0 0 0 0 0 0 0 0 0 0 0 0 0
0 0 0 0 0 0 0 0 0 0 0 0 0
0 0 0 0 0 0 0 0 0 0 0 0 0
0 0 0 0 0 0 0 0 0 0 0 0 0
0 0 0 0 0 0 0 0 0 0 0 0 0
0 0 14 0 0 0 0 0 3 0 0 0 0
0 0 0 0 0 0 0 0 0 0 0 0 0
0 0 0 0 0 0 0 0 0 0 0 0 0
0 0 0 0 0 0 0 0 0 0 0 0 0
0 0 0 0 0 0 0 0 0 0 0 0 0
0 4 0 0 0 0 0 0 0 0 0 0 0
0 0 0 0 8 0 0 0 0 0 0 0 0
0 0 0 6 0 0 0 0 0 0 0 0 0
0 0 0 0 0 0 15 0 0 0 0 0 0
0 0 0 0 0 12 0 0 0 0 0 0 0
0 2 0 0 0 0 0 0 0 0 0 7 0
0 0 0 0 0 0 0 0 0 0 0 0 0
0 0 0 0 0 0 0 0 0 0 0 0 0
0 0 0 13 0 11 0 0 0 0 0 0 0
0 0 0 0 0 0 0 0 0 0 0 0 0
