13
19
1
1
0
0
0
0
6
2
5
30
15
10 10 10 10 10 10 10 10 10 10 10 10 10
10 10 10 10 10 10 10 10 10 10 10 10 10
10 10 10 10 10 10 10 10 10 10 10 10 10
8 8 8 8 8 8 8 8 8 8 8 8 8
10 3 10 4 10 5 10 6 10 7 10 0 10
10 8 10 8 10 8 10 8 10 8 10 8 10
6 10 5 10 4 10 3 10 2 10 1 10 0
8 10 8 10 8 10 8 10 8 10 8 10 8
10 2 10 3 10 4 10 5 10 6 10 7 10
8 8 8 8 8 8 8 8 8 8 8 8 8
7 10 6 10 5 10 4 10 3 10 2 10 1
8 10 8 10 8 10 8 10 8 10 8 10 8
10 1 10 2 10 3 10 4 10 5 10 6 10
10 8 10 8 10 8 10 8 10 8 10 8 10
0 10 7 10 6 10 5 10 4 10 3 10 2
8 8 8 8 8 8 8 8 8 8 8 8 8
10 10 10 10 10 10 10 10 10 10 10 10 10
10 10 10 10 10 10 10 10 10 10 10 10 10
10 10 10 10 10 10 10 10 10 10 10 10 10
0 0 0 0 0 0 0 0 0 0 0 0 0
0 0 0 0 0 0 0 0 0 0 0 0 0
0 0 0 0 0 0 0 0 0 0 0 0 0
0 0 0 4 0 7 7 0 0 0 2 0 0
0 0 0 0 0 0 0 0 0 0 0 0 0
0 0 0 0 0 0 0 0 0 0 0 0 0
0 0 0 0 0 0 0 0 5 0 1 0 0
0 0 6 0 7 0 2 0 0 0 0 0 0
0 0 0 0 0 4 0 0 0 0 0 0 0
0 0 0 0 4 0 0 0 5 0 0 0 0
0 0 0 0 7 0 0 0 0 0 0 0 0
0 0 0 0 0 0 0 0 0 0 0 0 0
0 0 0 0 0 0 0 0 0 2 0 0 0
0 0 0 0 0 0 0 0 0 7 0 0 0
0 0 0 0 0 0 0 0 7 0 5 0 0
0 0 0 0 0 0 4 5 0 0 0 0 0
0 0 0 0 0 0 0 0 0 0 0 0 0
0 0 0 0 0 0 0 0 0 0 0 0 0
0 0 0 0 0 0 0 0 0 0 0 0 0
0 0 0 0 0 0 0 0 0 0 0 0 0
0 0 0 0 0 0 0 0 0 0 0 0 0
0 0 0 0 0 0 0 0 0 0 0 0 0
0 0 0 7 0 12 9 0 0 0 5 0 0
0 0 0 0 0 0 0 0 0 0 0 0 0
0 14 0 0 0 0 0 0 0 0 0 0 0
0 0 0 0 0 0 0 0 8 0 0 0 0
0 0 9 0 2 0 3 0 0 0 0 0 0
0 0 0 0 0 6 0 0 0 0 0 0 0
0 0 0 0 2 0 0 0 9 0 0 0 0
0 0 0 0 8 0 0 0 0 0 0 0 0
0 0 0 0 0 0 0 0 0 0 0 0 0
0 0 0 0 0 0 0 0 0 3 0 0 0
0 0 0 0 0 0 0 0 0 14 0 0 0
0 0 0 0 0 0 0 0 13 0 1 0 0
0 0 8 0 0 0 0 9 0 0 0 0 0
0 0 0 0 0 0 0 0 0 0 0 0 0
0 0 0 0 0 0 0 0 0 0 0 0 0
0 0 0 0 0 0 0 0 0 0 0 0 0
