11
17
1
1
0
0
0
0
8
5
5
30
15
10 10 10 10 10 10 10 10 10 10 10
10 10 10 10 10 10 10 10 10 10 10
10 10 10 10 10 10 10 10 10 10 10
10 9 10 10 10 10 10 10 10 9 10
10 9 9 10 10 10 10 10 9 9 10
10 9 9 9 10 10 10 9 9 9 10
10 9 2 9 9 9 9 9 3 9 10
10 9 2 9 9 9 9 9 3 9 10
10 9 10 9 6 9 4 9 10 9 10
10 9 10 9 6 9 4 9 10 9 10
10 9 10 9 10 9 10 9 10 9 10
10 9 10 9 10 9 10 9 10 9 10
10 9 10 9 10 9 10 9 10 9 10
10 10 10 9 10 9 10 9 10 10 10
10 10 10 10 10 9 10 10 10 10 10
10 10 10 10 10 9 10 10 10 10 10
10 10 10 10 10 10 10 10 10 10 10
0 0 0 0 0 0 0 0 0 0 0
0 0 0 0 0 0 0 0 0 0 0
0 0 0 0 0 0 0 0 0 0 0
0 0 0 0 0 0 0 0 0 0 0
0 0 0 0 0 0 0 0 0 0 0
0 0 0 0 0 0 0 0 0 0 0
0 0 0 0 0 0 0 0 0 0 0
0 0 1 0 0 0 0 0 2 0 0
0 0 0 0 0 0 2 0 0 0 0
0 0 0 0 1 0 0 0 0 0 0
0 0 0 0 0 0 0 0 0 0 0
0 0 0 0 0 0 0 0 0 0 0
0 0 0 0 0 0 0 0 0 0 0
0 0 0 0 0 0 0 0 0 0 0
0 0 0 0 0 0 0 0 0 0 0
0 0 0 0 0 0 0 0 0 0 0
0 0 0 0 0 0 0 0 0 0 0
0 0 0 0 0 0 0 0 0 0 0
0 0 0 0 0 0 0 0 0 0 0
0 0 0 0 0 0 0 0 0 0 0
0 0 0 0 0 0 0 0 0 0 0
0 0 0 0 0 0 0 0 0 0 0
0 0 0 0 0 0 0 0 0 0 0
0 0 0 0 0 0 0 0 0 0 0
0 0 3 0 0 0 0 0 3 0 0
0 0 0 0 0 0 5 0 0 0 0
0 0 0 0 6 0 0 0 0 0 0
0 0 0 0 0 0 0 0 0 0 0
0 0 0 0 0 0 0 0 0 0 0
0 0 0 0 0 0 0 0 0 0 0
0 0 0 0 0 0 0 0 0 0 0
0 0 0 0 0 0 0 0 0 0 0
0 0 0 0 0 0 0 0 0 0 0
0 0 0 0 0 0 0 0 0 0 0
