11
17
1
1
0
0
0
0
15
2
5
30
15
10 10 10 10 10 4 10 10 10 10 10
10 10 10 10 10 8 10 10 10 10 10
10 10 10 10 10 4 10 10 10 10 10
10 10 10 10 10 8 10 10 10 10 10
10 10 10 10 10 4 10 10 10 10 10
10 10 10 10 10 4 10 10 10 10 10
10 4 4 4 9 4 9 4 4 4 10
8 8 8 8 4 4 4 8 8 8 8
10 10 10 10 9 4 9 10 10 10 10
4 4 4 4 4 4 4 4 4 4 4
8 8 8 8 9 4 9 8 8 8 8
10 10 10 10 10 4 10 10 10 10 10
10 10 10 9 9 10 9 9 10 10 10
10 10 10 9 9 10 9 9 10 10 10
10 10 10 10 10 10 10 10 10 10 10
10 10 10 10 10 10 10 10 10 10 10
10 10 10 10 10 10 10 10 10 10 10
0 0 0 0 0 0 0 0 0 0 0
0 0 0 0 0 0 0 0 0 0 0
0 0 0 0 0 0 0 0 0 0 0
0 0 0 0 0 0 0 0 0 0 0
0 0 0 0 0 0 0 0 0 0 0
0 0 0 0 0 0 0 0 0 0 0
0 0 0 1 0 0 0 0 0 0 0
0 0 0 0 0 0 0 0 1 0 0
0 0 0 0 0 0 0 0 0 0 0
1 0 0 0 0 0 0 2 0 2 0
0 0 2 0 0 0 0 0 0 0 1
0 0 0 0 0 0 0 0 0 0 0
0 0 0 0 0 0 0 0 0 0 0
0 0 0 0 0 0 0 0 0 0 0
0 0 0 0 0 0 0 0 0 0 0
0 0 0 0 0 0 0 0 0 0 0
0 0 0 0 0 0 0 0 0 0 0
0 0 0 0 0 0 0 0 0 0 0
0 0 0 0 0 0 0 0 0 0 0
0 0 0 0 0 0 0 0 0 0 0
0 0 0 0 0 0 0 0 0 0 0
0 0 0 0 0 0 0 0 0 0 0
0 0 0 0 0 0 0 0 0 0 0
0 0 0 6 0 0 0 0 0 0 0
0 0 0 0 0 0 0 0 3 0 0
0 0 0 0 0 0 0 0 0 0 0
3 0 0 0 0 0 0 4 0 12 0
0 0 15 0 0 0 0 0 0 0 13
0 0 0 0 0 0 0 0 0 0 0
0 0 0 0 0 0 0 0 0 0 0
0 0 0 0 0 0 0 0 0 0 0
0 0 0 0 0 0 0 0 0 0 0
0 0 0 0 0 0 0 0 0 0 0
0 0 0 0 0 0 0 0 0 0 0
