11
17
1
1
1
0
1
0
1
5
5
35
18
10 10 10 10 10 10 10 10 10 10 10
10 10 10 10 10 10 10 10 10 10 10
10 10 10 10 3 0 4 10 10 10 10
10 10 10 3 3 0 4 4 10 10 10
10 10 4 3 0 0 0 4 3 10 10
10 0 3 3 0 0 0 4 4 0 10
10 0 3 3 0 0 0 4 4 0 10
10 0 3 3 0 0 0 4 4 0 10
10 0 3 3 0 0 0 4 4 0 10
10 10 4 3 0 0 0 4 3 10 10
10 10 8 3 3 0 4 4 8 10 10
10 10 8 10 3 0 4 10 8 10 10
10 10 10 8 10 8 10 8 10 10 10
10 10 10 8 10 8 10 8 10 10 10
10 10 10 10 9 9 9 10 10 10 10
10 10 10 10 9 9 9 10 10 10 10
10 10 10 10 10 10 10 10 10 10 10
0 0 0 0 0 0 0 0 0 0 0
0 0 0 0 0 0 0 0 0 0 0
0 0 0 0 4 0 0 0 0 0 0
0 0 0 0 0 0 0 2 0 0 0
0 0 1 0 0 0 0 0 0 0 0
0 0 0 0 2 0 0 0 0 0 0
0 0 0 0 0 0 0 0 0 0 0
0 2 0 0 0 0 0 0 0 0 0
0 0 0 0 0 0 0 0 3 0 0
0 0 2 0 0 0 0 0 0 0 0
0 0 0 0 0 0 0 0 0 0 0
0 0 1 0 0 0 0 0 1 0 0
0 0 0 0 0 2 0 0 0 0 0
0 0 0 2 0 0 0 0 0 0 0
0 0 0 0 0 0 0 0 0 0 0
0 0 0 0 0 0 0 0 0 0 0
0 0 0 0 0 0 0 0 0 0 0
0 0 0 0 0 0 0 0 0 0 0
0 0 0 0 0 0 0 0 0 0 0
0 0 0 0 3 0 0 0 0 0 0
0 0 0 0 0 0 0 3 0 0 0
0 0 1 0 0 0 0 0 0 0 0
0 0 0 0 4 0 0 0 0 0 0
0 0 0 0 0 0 0 0 0 0 0
0 9 0 0 0 0 0 0 0 0 0
0 0 0 0 0 0 0 0 5 0 0
0 0 6 0 0 0 0 0 0 0 0
0 0 0 0 0 0 0 0 0 0 0
0 0 12 0 0 0 0 0 10 0 0
0 0 0 0 0 13 0 0 0 0 0
0 0 0 0 0 0 0 0 0 0 0
0 0 0 0 0 0 0 0 0 0 0
0 0 0 0 0 0 0 0 0 0 0
0 0 0 0 0 0 0 0 0 0 0
