11
17
1
1
0
0
0
0
7
1
5
30
15
10 10 10 10 10 10 10 10 10 10 10
10 10 10 10 10 10 10 10 10 10 10
10 10 10 9 8 8 8 9 10 10 10
10 10 9 7 7 7 7 7 9 10 10
2 9 7 7 7 7 7 7 7 9 2
2 9 7 7 7 7 7 7 7 9 2
2 9 7 7 7 7 7 7 7 9 2
2 9 7 7 7 7 7 7 7 9 2
2 9 8 9 7 7 7 9 8 9 2
2 9 10 9 9 9 9 9 10 9 2
2 9 10 6 10 2 10 6 10 9 2
2 9 10 6 10 2 10 6 10 9 2
2 9 10 6 10 2 10 6 10 9 2
2 9 9 6 10 2 10 6 9 9 2
10 10 10 10 10 10 10 10 10 10 10
10 10 10 10 10 10 10 10 10 10 10
10 10 10 10 10 10 10 10 10 10 10
0 0 0 0 0 0 0 0 0 0 0
0 0 0 0 0 0 0 0 0 0 0
0 0 0 0 0 0 2 0 0 0 0
0 0 0 0 1 0 0 0 0 0 0
0 0 0 0 0 0 0 0 0 0 0
2 0 0 0 0 0 0 1 0 0 3
0 0 0 0 0 1 0 0 0 0 0
0 0 0 0 0 0 0 0 0 0 0
0 0 3 0 0 0 0 0 0 0 0
0 0 0 0 0 0 0 0 0 0 0
0 0 0 2 0 0 0 1 0 0 0
0 0 0 0 0 0 0 0 0 0 2
0 0 0 0 0 1 0 2 0 0 0
1 0 0 0 0 0 0 0 0 0 0
0 0 0 0 0 0 0 0 0 0 0
0 0 0 0 0 0 0 0 0 0 0
0 0 0 0 0 0 0 0 0 0 0
0 0 0 0 0 0 0 0 0 0 0
0 0 0 0 0 0 0 0 0 0 0
0 0 0 0 0 0 8 0 0 0 0
0 0 0 0 13 0 0 0 0 0 0
0 0 0 0 0 0 0 0 0 0 0
3 0 0 0 0 0 0 9 0 0 13
0 0 0 0 0 0 0 0 0 0 0
0 0 0 0 0 0 0 0 0 0 0
0 0 0 0 0 0 0 0 0 0 0
0 0 0 0 0 0 0 0 0 0 0
0 0 0 4 0 0 0 3 0 0 0
0 0 0 0 0 0 0 0 0 0 2
0 0 0 0 0 2 0 1 0 0 0
2 0 0 0 0 0 0 0 0 0 0
0 0 0 0 0 0 0 0 0 0 0
0 0 0 0 0 0 0 0 0 0 0
0 0 0 0 0 0 0 0 0 0 0
