11
17
1
1
0
0
0
0
8
2
5
30
15
10 10 10 10 10 10 10 10 10 10 10
10 10 10 10 10 10 10 10 10 10 10
10 10 10 10 10 10 10 10 10 10 10
10 10 10 10 10 10 10 10 10 10 10
10 9 10 10 10 10 10 10 10 9 10
10 3 9 9 9 9 9 9 9 3 10
10 6 6 6 6 6 6 6 6 6 10
10 0 0 0 0 0 0 0 0 0 10
10 6 6 6 6 6 6 6 6 6 10
10 0 0 0 0 0 0 0 0 0 10
10 3 9 9 3 3 3 9 9 3 10
10 9 10 9 3 3 3 9 10 9 10
10 10 10 9 8 8 8 9 10 10 10
10 10 10 10 10 10 10 10 10 10 10
10 10 10 10 10 10 10 10 10 10 10
10 10 10 10 10 10 10 10 10 10 10
10 10 10 10 10 10 10 10 10 10 10
0 0 0 0 0 0 0 0 0 0 0
0 0 0 0 0 0 0 0 0 0 0
0 0 0 0 0 0 0 0 0 0 0
0 0 0 0 0 0 0 0 0 0 0
0 0 0 0 0 0 0 0 0 0 0
0 0 0 0 0 0 0 0 0 0 0
0 0 0 0 0 1 0 0 2 0 0
0 3 0 1 0 0 0 0 0 0 0
0 0 0 0 0 0 0 2 0 0 0
0 0 0 0 1 0 0 0 0 2 0
0 2 0 0 0 0 0 0 0 0 0
0 0 0 0 0 0 1 0 0 0 0
0 0 0 0 2 0 0 0 0 0 0
0 0 0 0 0 0 0 0 0 0 0
0 0 0 0 0 0 0 0 0 0 0
0 0 0 0 0 0 0 0 0 0 0
0 0 0 0 0 0 0 0 0 0 0
0 0 0 0 0 0 0 0 0 0 0
0 0 0 0 0 0 0 0 0 0 0
0 0 0 0 0 0 0 0 0 0 0
0 0 0 0 0 0 0 0 0 0 0
0 0 0 0 0 0 0 0 0 0 0
0 0 0 0 0 0 0 0 0 0 0
0 0 0 0 0 6 0 0 12 0 0
0 8 0 0 0 0 0 0 0 0 0
0 0 0 0 0 0 0 13 0 0 0
0 0 0 0 13 0 0 0 0 2 0
0 3 0 0 0 0 0 0 0 0 0
0 0 0 0 0 0 9 0 0 0 0
0 0 0 0 2 0 0 0 0 0 0
0 0 0 0 0 0 0 0 0 0 0
0 0 0 0 0 0 0 0 0 0 0
0 0 0 0 0 0 0 0 0 0 0
0 0 0 0 0 0 0 0 0 0 0
