11
17
1
1
0
0
0
0
14
2
5
30
15
10 10 10 10 10 10 10 10 10 10 10
10 10 10 10 10 10 10 10 10 10 10
10 10 10 10 10 10 10 10 10 10 10
10 11 11 10 11 11 11 10 11 11 10
10 3 3 10 4 9 3 10 4 4 10
10 11 11 10 11 11 11 10 11 11 10
10 4 4 10 3 9 4 10 3 3 10
10 11 11 10 11 11 11 10 11 11 10
10 3 3 10 4 9 3 10 4 4 10
10 11 11 10 11 11 11 10 11 11 10
10 4 4 10 3 9 4 10 3 3 10
10 11 11 10 11 11 11 10 11 11 10
10 3 3 10 4 9 4 10 4 4 10
10 11 11 10 11 11 11 10 11 11 10
10 4 4 10 3 9 4 10 3 3 10
10 11 11 10 11 11 11 10 11 11 10
10 10 10 10 10 10 10 10 10 10 10
0 0 0 0 0 0 0 0 0 0 0
0 0 0 0 0 0 0 0 0 0 0
0 0 0 0 0 0 0 0 0 0 0
0 0 0 0 0 0 0 0 0 0 0
0 0 2 0 0 0 0 0 0 1 0
0 0 0 0 0 0 0 0 0 0 0
0 2 0 0 0 0 1 0 0 2 0
0 0 0 0 0 0 0 0 0 0 0
0 0 0 0 3 0 0 0 0 0 0
0 0 0 0 0 0 0 0 0 0 0
0 0 0 0 2 0 0 0 0 0 0
0 0 0 0 0 0 0 0 0 0 0
0 0 4 0 0 0 0 0 0 1 0
0 0 0 0 0 3 0 0 0 0 0
0 0 0 0 0 0 3 0 0 0 0
0 0 0 0 0 0 0 0 0 0 0
0 0 0 0 0 0 0 0 0 0 0
0 0 0 0 0 0 0 0 0 0 0
0 0 0 0 0 0 0 0 0 0 0
0 0 0 0 0 0 0 0 0 0 0
0 0 0 0 0 0 0 0 0 0 0
0 0 3 0 0 0 0 0 0 9 0
0 0 0 0 0 0 0 0 0 0 0
0 6 0 0 0 0 15 0 0 13 0
0 0 0 0 0 0 0 0 0 0 0
0 0 0 0 5 0 0 0 0 0 0
0 0 0 0 0 0 0 0 0 0 0
0 0 0 0 4 0 0 0 0 0 0
0 0 0 0 0 0 0 0 0 0 0
0 0 4 0 0 0 0 0 0 3 0
0 0 0 0 0 4 0 0 0 0 0
0 0 0 0 0 0 3 0 0 0 0
0 0 0 0 0 0 0 0 0 0 0
0 0 0 0 0 0 0 0 0 0 0
