11
17
1
1
0
0
0
0
3
3
5
30
15
10 10 10 10 10 10 10 10 10 10 10
10 10 10 10 10 10 10 10 10 10 10
10 10 4 3 6 9 6 3 4 10 10
10 10 4 3 6 9 6 3 4 10 10
10 10 4 3 6 9 6 3 4 10 10
10 10 4 3 6 0 6 3 4 10 10
10 10 4 3 6 9 6 3 4 10 10
10 10 4 3 6 9 6 3 4 10 10
10 10 4 3 6 9 6 3 4 10 10
10 10 10 10 10 10 10 10 10 10 10
11 11 11 11 11 11 11 11 11 11 11
10 10 10 10 10 10 10 10 10 10 10
11 11 11 11 11 11 11 11 11 11 11
10 10 10 10 10 10 10 10 10 10 10
11 11 11 11 11 11 11 11 11 11 11
10 10 10 10 10 10 10 10 10 10 10
10 10 10 10 10 10 10 10 10 10 10
0 0 0 0 0 0 0 0 0 0 0
0 0 0 0 0 0 0 0 0 0 0
0 0 0 0 0 0 0 0 0 0 0
0 0 0 0 0 0 0 2 0 0 0
0 0 0 0 0 0 0 0 0 0 0
0 0 0 0 0 0 0 0 0 0 0
0 0 3 0 0 0 0 0 0 0 0
0 0 0 0 0 0 0 0 0 0 0
0 0 0 0 0 0 0 0 0 0 0
0 0 0 0 0 0 0 0 0 0 0
0 0 0 0 0 0 0 0 0 0 2
0 0 0 0 0 0 0 0 0 0 0
0 3 0 0 0 0 2 0 0 0 0
0 0 0 0 0 0 0 0 0 0 0
2 0 0 2 0 0 0 0 3 0 0
0 0 0 0 0 0 0 0 0 0 0
0 0 0 0 0 0 0 0 0 0 0
0 0 0 0 0 0 0 0 0 0 0
0 0 0 0 0 0 0 0 0 0 0
0 0 0 0 0 0 0 0 0 0 0
0 0 0 0 0 0 0 8 0 0 0
0 0 0 0 0 0 0 0 0 0 0
0 0 0 0 0 0 0 0 0 0 0
0 0 5 0 0 0 0 0 0 0 0
0 0 0 0 0 0 0 0 0 0 0
0 0 0 0 0 0 0 0 0 0 0
0 0 0 0 0 0 0 0 0 0 0
0 0 0 0 0 0 0 0 0 0 2
0 0 0 0 0 0 0 0 0 0 0
0 4 0 0 0 0 3 0 0 0 0
0 0 0 0 0 0 0 0 0 0 0
2 0 0 3 0 0 0 0 4 0 0
0 0 0 0 0 0 0 0 0 0 0
0 0 0 0 0 0 0 0 0 0 0
