11
17
1
1
0
1
0
1
3
3
5
30
15
10 10 10 10 10 10 10 10 10 10 10
10 10 10 10 10 10 10 10 10 10 10
10 10 10 10 10 10 10 10 10 10 10
4 4 4 4 4 4 4 4 4 4 4
4 4 4 4 4 4 4 4 4 4 4
10 4 4 10 10 10 10 10 4 4 10
10 4 4 10 10 10 10 10 4 4 10
10 10 4 4 10 10 10 4 4 10 10
10 10 4 4 10 10 10 4 4 10 10
10 10 10 4 4 10 4 4 10 10 10
10 10 10 4 4 10 4 4 10 10 10
10 10 10 10 4 4 4 10 10 10 10
10 10 10 10 4 4 4 10 10 10 10
10 10 10 10 10 4 10 10 10 10 10
10 10 10 10 10 4 10 10 10 10 10
10 10 10 10 10 10 10 10 10 10 10
10 10 10 10 10 10 10 10 10 10 10
0 0 0 0 0 0 0 0 0 0 0
0 0 0 0 0 0 0 0 0 0 0
0 0 0 0 0 0 0 0 0 0 0
0 0 0 0 1 0 0 0 0 0 2
1 0 0 3 0 0 2 0 0 0 0
0 0 0 0 0 0 0 0 0 0 0
0 3 0 0 0 0 0 0 1 0 0
0 0 0 0 0 0 0 1 0 0 0
0 0 0 2 0 0 0 0 0 0 0
0 0 0 0 0 0 0 0 0 0 0
0 0 0 0 0 0 0 1 0 0 0
0 0 0 0 0 0 0 0 0 0 0
0 0 0 0 3 0 0 0 0 0 0
0 0 0 0 0 0 0 0 0 0 0
0 0 0 0 0 0 0 0 0 0 0
0 0 0 0 0 0 0 0 0 0 0
0 0 0 0 0 0 0 0 0 0 0
0 0 0 0 0 0 0 0 0 0 0
0 0 0 0 0 0 0 0 0 0 0
0 0 0 0 0 0 0 0 0 0 0
0 0 0 0 10 0 0 0 0 0 13
9 0 0 8 0 0 6 0 0 0 0
0 0 0 0 0 0 0 0 0 0 0
0 4 0 0 0 0 0 0 2 0 0
0 0 0 0 0 0 0 2 0 0 0
0 0 0 3 0 0 0 0 0 0 0
0 0 0 0 0 0 0 0 0 0 0
0 0 0 0 0 0 0 1 0 0 0
0 0 0 0 0 0 0 0 0 0 0
0 0 0 0 3 0 0 0 0 0 0
0 0 0 0 0 0 0 0 0 0 0
0 0 0 0 0 0 0 0 0 0 0
0 0 0 0 0 0 0 0 0 0 0
0 0 0 0 0 0 0 0 0 0 0
