11
17
0
0
0
0
0
0
7
5
5
30
15
10 9 10 10 10 10 10 10 10 9 10
10 9 10 3 4 3 4 3 10 9 10
10 9 10 2 5 2 5 2 10 9 10
10 9 10 5 2 5 2 5 10 9 10
10 9 10 4 3 4 3 4 10 9 10
10 9 10 10 10 10 10 10 10 9 10
10 9 11 11 11 11 11 11 11 9 10
10 10 10 10 10 10 10 10 10 10 10
10 9 11 11 11 11 11 11 11 9 10
10 9 10 10 10 10 10 10 10 9 10
10 9 10 2 4 2 4 2 10 9 10
10 9 10 5 3 5 3 5 10 9 10
10 9 10 3 5 3 5 3 10 9 10
10 9 10 4 2 4 2 4 10 9 10
10 9 10 10 10 10 10 10 10 9 10
10 9 9 9 9 9 9 9 9 9 10
10 10 10 10 10 10 10 10 10 10 10
0 0 0 0 0 0 0 0 0 0 0
0 0 0 0 0 0 0 0 0 0 0
0 0 0 0 0 0 0 0 0 0 0
0 0 0 0 1 0 0 0 0 0 0
0 0 0 0 0 2 0 2 0 0 0
0 0 0 0 0 0 0 0 0 0 0
0 0 0 0 0 0 0 0 0 0 0
0 0 0 0 0 0 0 0 0 0 0
0 0 0 2 0 0 0 0 0 0 0
0 0 0 0 0 0 0 0 0 0 0
0 0 0 1 0 3 0 0 0 0 0
0 0 0 0 0 0 0 0 0 0 0
0 0 0 0 0 0 0 0 0 0 0
0 0 0 0 0 0 0 0 0 0 0
0 0 0 0 0 0 0 0 0 0 0
0 0 0 0 0 0 0 0 0 0 0
0 0 0 0 0 0 0 0 0 0 0
0 0 0 0 0 0 0 0 0 0 0
0 0 0 0 0 0 0 0 0 0 0
0 0 0 0 0 0 0 0 0 0 0
0 0 0 0 6 0 0 0 0 0 0
0 0 0 0 0 8 0 3 0 0 0
0 0 0 0 0 0 0 0 0 0 0
0 0 0 0 0 0 0 0 0 0 0
0 0 0 0 0 0 0 0 0 0 0
0 0 0 3 0 0 0 0 0 0 0
0 0 0 0 0 0 0 0 0 0 0
0 0 0 9 0 5 0 0 0 0 0
0 0 0 0 0 0 0 0 0 0 0
0 0 0 0 0 0 0 0 0 0 0
0 0 0 0 0 0 0 0 0 0 0
0 0 0 0 0 0 0 0 0 0 0
0 0 0 0 0 0 0 0 0 0 0
0 0 0 0 0 0 0 0 0 0 0
