11
17
0
0
0
0
0
0
13
1
5
30
15
10 10 10 10 10 10 10 10 10 10 10
10 10 3 10 5 10 5 10 3 10 10
10 6 10 4 10 4 10 4 10 6 10
10 10 3 10 5 10 5 10 3 10 10
10 6 10 4 10 4 10 4 10 6 10
10 10 3 10 5 10 5 10 3 10 10
10 6 10 4 10 4 10 4 10 6 10
10 10 3 10 5 10 5 10 3 10 10
10 6 10 4 10 11 10 4 10 6 10
10 10 3 10 11 4 11 10 3 10 10
10 6 10 4 10 9 10 4 10 6 10
10 10 3 10 5 10 5 10 3 10 10
10 6 10 4 10 4 10 4 10 6 10
10 10 3 10 5 10 5 10 3 10 10
10 6 10 4 10 4 10 4 10 6 10
10 10 3 10 5 10 5 10 3 10 10
10 6 10 4 10 4 10 4 10 6 10
0 0 0 0 0 0 0 0 0 0 0
0 0 0 0 0 0 2 0 0 0 0
0 0 0 0 0 0 0 0 0 0 0
0 0 0 0 0 0 0 0 0 0 0
0 0 0 0 0 0 0 2 0 0 0
0 0 0 0 1 0 0 0 0 0 0
0 1 0 0 0 0 0 1 0 0 0
0 0 0 0 0 0 0 0 0 0 0
0 0 0 0 0 0 0 0 0 1 0
0 0 0 0 0 0 0 0 0 0 0
0 0 0 1 0 0 0 1 0 0 0
0 0 2 0 0 0 0 0 0 0 0
0 0 0 2 0 0 0 0 0 0 0
0 0 0 0 0 0 0 0 0 0 0
0 3 0 0 0 2 0 0 0 2 0
0 0 0 0 0 0 0 0 0 0 0
0 0 0 0 0 0 0 0 0 0 0
0 0 0 0 0 0 0 0 0 0 0
0 0 0 0 0 0 4 0 0 0 0
0 0 0 0 0 0 0 0 0 0 0
0 0 0 0 0 0 0 0 0 0 0
0 0 0 0 0 0 0 2 0 0 0
0 0 0 0 9 0 0 0 0 0 0
0 1 0 0 0 0 0 10 0 0 0
0 0 0 0 0 0 0 0 0 0 0
0 0 0 0 0 0 0 0 0 3 0
0 0 0 0 0 0 0 0 0 0 0
0 0 0 0 0 0 0 2 0 0 0
0 0 8 0 0 0 0 0 0 0 0
0 0 0 12 0 0 0 0 0 0 0
0 0 0 0 0 0 0 0 0 0 0
0 11 0 0 0 3 0 0 0 9 0
0 0 0 0 0 0 0 0 0 0 0
0 0 0 0 0 0 0 0 0 0 0
