11
17
1
1
0
0
0
0
1
0
5
30
15
10 10 10 10 10 10 10 10 10 10 10
10 10 10 10 10 10 10 10 10 10 10
10 10 0 10 10 10 10 10 0 10 10
10 0 0 0 10 9 10 0 0 0 10
10 0 0 0 10 10 10 0 0 0 10
10 0 9 10 0 0 0 10 9 0 10
10 10 9 0 6 4 6 0 9 10 10
10 10 0 6 6 4 6 6 0 10 10
10 10 0 6 6 4 6 6 0 10 10
10 10 0 6 6 4 4 6 0 10 10
10 10 0 6 6 4 4 6 0 10 10
10 10 0 6 6 6 6 6 0 10 10
10 10 9 0 6 6 6 0 9 10 10
10 10 9 0 6 6 6 0 9 10 10
10 2 2 10 0 0 0 10 2 2 10
2 2 2 2 10 10 10 2 2 2 2
10 10 10 10 10 10 10 10 10 10 10
0 0 0 0 0 0 0 0 0 0 0
0 0 0 0 0 0 0 0 0 0 0
0 0 0 0 0 0 0 0 0 0 0
0 2 0 0 0 0 0 0 0 0 0
0 0 0 0 0 0 0 0 0 1 0
0 0 0 0 0 0 0 0 0 0 0
0 0 0 0 0 0 0 0 0 0 0
0 0 0 0 0 0 0 0 0 0 0
0 0 2 0 0 0 0 0 0 0 0
0 0 0 0 0 0 1 0 0 0 0
0 0 0 0 1 0 0 0 0 0 0
0 0 0 0 1 0 0 0 0 0 0
0 0 0 0 0 0 0 0 0 0 0
0 0 0 0 0 2 0 0 0 0 0
0 3 0 0 0 0 0 0 0 0 0
0 0 0 0 0 0 0 0 0 0 0
0 0 0 0 0 0 0 0 0 0 0
0 0 0 0 0 0 0 0 0 0 0
0 0 0 0 0 0 0 0 0 0 0
0 0 0 0 0 0 0 0 0 0 0
0 10 0 0 0 0 0 0 0 0 0
0 0 0 0 0 0 0 0 0 9 0
0 0 0 0 0 0 0 0 0 0 0
0 0 0 0 0 0 0 0 0 0 0
0 0 0 0 0 0 0 0 0 0 0
0 0 13 0 0 0 0 0 0 0 0
0 0 0 0 0 0 4 0 0 0 0
0 0 0 0 0 0 0 0 0 0 0
0 0 0 0 1 0 0 0 0 0 0
0 0 0 0 0 0 0 0 0 0 0
0 0 0 0 0 3 0 0 0 0 0
0 13 0 0 0 0 0 0 0 0 0
0 0 0 0 0 0 0 0 0 0 0
0 0 0 0 0 0 0 0 0 0 0
