11
17
1
1
0
0
0
0
4
3
5
30
15
10 10 10 10 10 10 10 10 10 10 10
10 10 10 10 10 10 10 10 10 10 10
10 10 10 10 10 10 10 10 10 10 10
0 2 2 5 5 9 4 4 3 3 0
0 2 2 5 5 9 4 4 3 3 0
2 5 5 4 4 9 3 3 0 0 2
2 5 5 4 4 9 3 3 0 0 2
5 4 4 3 3 9 0 0 2 2 5
5 4 4 3 3 9 0 0 2 2 5
4 3 3 0 0 9 2 2 5 5 4
4 3 3 0 0 9 2 2 5 5 4
3 0 0 2 2 9 5 5 4 4 3
3 0 0 2 2 9 5 5 4 4 3
0 2 2 5 5 9 4 4 3 3 0
0 2 2 5 5 9 4 4 3 3 0
10 10 10 10 10 10 10 10 10 10 10
10 10 10 10 10 10 10 10 10 10 10
0 0 0 0 0 0 0 0 0 0 0
0 0 0 0 0 0 0 0 0 0 0
0 0 0 0 0 0 0 0 0 0 0
0 0 0 0 0 0 0 0 0 0 0
0 0 0 0 0 0 0 0 0 0 0
0 0 0 0 0 0 0 0 0 0 0
0 0 0 0 0 0 0 0 0 0 0
0 0 0 0 0 0 0 0 0 0 0
2 0 0 0 1 0 0 0 0 0 0
0 0 0 0 0 0 1 0 0 0 0
0 0 0 0 0 0 0 0 0 0 0
0 0 0 3 0 0 0 0 0 0 0
0 0 0 0 0 0 0 0 0 0 0
1 2 0 0 1 0 0 0 1 0 3
0 0 0 0 0 0 3 0 0 0 2
0 0 0 0 0 0 0 0 0 0 0
0 0 0 0 0 0 0 0 0 0 0
0 0 0 0 0 0 0 0 0 0 0
0 0 0 0 0 0 0 0 0 0 0
0 0 0 0 0 0 0 0 0 0 0
0 0 0 0 0 0 0 0 0 0 0
0 0 0 0 0 0 0 0 0 0 0
0 0 0 0 0 0 0 0 0 0 0
0 0 0 0 0 0 0 0 0 0 0
0 0 0 0 0 0 0 0 0 0 0
8 0 0 0 9 0 0 0 0 0 0
0 0 0 0 0 0 13 0 0 0 0
0 0 0 0 0 0 0 0 0 0 0
0 0 0 3 0 0 0 0 0 0 0
0 0 0 0 0 0 0 0 0 0 0
0 3 0 0 9 0 0 0 2 0 4
0 0 0 0 0 0 4 0 0 0 4
0 0 0 0 0 0 0 0 0 0 0
0 0 0 0 0 0 0 0 0 0 0
