11
17
1
1
0
1
0
1
14
1
5
30
15
10 10 10 10 10 10 10 10 10 10 10
10 10 10 10 10 10 10 10 10 10 10
10 10 10 9 9 9 9 9 10 10 10
10 10 9 0 0 9 0 0 9 10 10
10 10 9 0 3 9 3 0 9 10 10
10 10 9 0 3 9 3 0 9 10 10
10 10 10 4 4 4 4 4 10 10 10
10 10 4 4 8 4 8 4 4 10 10
10 4 0 8 0 8 0 8 0 4 10
4 8 0 8 0 8 0 8 0 8 4
4 4 8 0 8 0 8 0 8 4 4
10 4 4 0 8 0 8 0 4 4 10
10 10 10 4 4 4 4 4 10 10 10
10 10 10 10 10 4 10 10 10 10 10
10 10 10 10 10 0 10 10 10 10 10
10 10 10 10 10 3 0 3 10 10 10
10 10 10 10 10 10 10 10 10 10 10
0 0 0 0 0 0 0 0 0 0 0
0 0 0 0 0 0 0 0 0 0 0
0 0 0 0 0 0 0 0 0 0 0
0 0 0 0 0 0 0 0 0 0 0
0 0 0 0 0 0 0 0 0 0 0
0 0 0 0 0 0 0 0 0 0 0
0 0 0 0 0 0 0 0 0 0 0
0 0 0 0 0 0 0 0 1 0 0
0 2 0 0 0 0 0 0 0 0 0
0 0 0 0 0 0 0 0 0 0 0
0 0 0 0 0 0 0 0 0 0 1
0 2 0 0 0 0 0 0 0 0 0
0 0 0 0 0 0 2 0 0 0 0
0 0 0 0 0 0 0 0 0 0 0
0 0 0 0 0 0 0 0 0 0 0
0 0 0 0 0 1 0 2 0 0 0
0 0 0 0 0 0 0 0 0 0 0
0 0 0 0 0 0 0 0 0 0 0
0 0 0 0 0 0 0 0 0 0 0
0 0 0 0 0 0 0 0 0 0 0
0 0 0 0 0 0 0 0 0 0 0
0 0 0 0 0 0 0 0 0 0 0
0 0 0 0 0 0 0 0 0 0 0
0 0 0 0 0 0 0 0 0 0 0
0 0 0 0 0 0 0 0 9 0 0
0 13 0 0 0 0 0 0 0 0 0
0 0 0 0 0 0 0 0 0 0 0
0 0 0 0 0 0 0 0 0 0 13
0 4 0 0 0 0 0 0 0 0 0
0 0 0 0 0 0 3 0 0 0 0
0 0 0 0 0 0 0 0 0 0 0
0 0 0 0 0 0 0 0 0 0 0
0 0 0 0 0 2 0 2 0 0 0
0 0 0 0 0 0 0 0 0 0 0
