11
17
1
1
0
0
0
0
10
0
5
30
15
10 10 10 10 10 10 10 10 10 10 10
10 10 10 10 10 10 10 10 10 10 10
10 10 10 10 10 10 10 10 10 10 10
9 9 9 9 9 10 9 9 9 9 9
9 9 9 9 9 10 9 9 9 9 9
3 3 3 3 3 3 3 3 3 3 3
6 6 6 6 6 6 6 6 6 6 6
6 0 0 0 0 0 0 0 0 0 6
6 0 11 11 11 11 11 11 11 0 6
6 0 11 10 10 10 10 10 11 0 6
6 0 11 10 10 10 10 10 11 0 6
6 0 11 11 9 10 9 11 11 0 6
6 0 0 0 9 10 9 0 0 0 6
6 6 6 6 9 10 9 6 6 6 6
3 3 3 3 9 10 9 3 3 3 3
9 9 9 9 9 10 9 9 9 9 9
9 9 9 9 9 10 9 9 9 9 9
0 0 0 0 0 0 0 0 0 0 0
0 0 0 0 0 0 0 0 0 0 0
0 0 0 0 0 0 0 0 0 0 0
0 0 0 0 0 0 0 0 0 0 0
0 0 0 0 0 0 0 0 0 0 0
0 0 0 0 0 1 0 0 0 0 0
2 0 0 2 0 0 0 0 0 0 0
0 0 0 0 0 0 0 0 0 0 0
0 0 3 0 0 0 0 0 0 0 0
0 0 0 0 0 0 0 0 0 0 0
1 0 0 0 0 0 0 0 0 2 0
0 2 0 0 0 0 0 4 0 0 0
0 0 0 0 0 0 0 2 0 0 0
0 0 0 0 0 0 0 0 0 0 0
0 0 0 0 0 0 0 0 0 0 0
0 0 0 0 0 0 0 0 0 0 0
0 0 0 0 0 0 0 0 0 0 0
0 0 0 0 0 0 0 0 0 0 0
0 0 0 0 0 0 0 0 0 0 0
0 0 0 0 0 0 0 0 0 0 0
0 0 0 0 0 0 0 0 0 0 0
0 0 0 0 0 0 0 0 0 0 0
0 0 0 0 0 3 0 0 0 0 0
6 0 0 8 0 0 0 0 0 0 0
0 0 0 0 0 0 0 0 0 0 0
0 0 13 0 0 0 0 0 0 0 0
0 0 0 0 0 0 0 0 0 0 0
9 0 0 0 0 0 0 0 0 8 0
0 15 0 0 0 0 0 3 0 0 0
0 0 0 0 0 0 0 3 0 0 0
0 0 0 0 0 0 0 0 0 0 0
0 0 0 0 0 0 0 0 0 0 0
0 0 0 0 0 0 0 0 0 0 0
0 0 0 0 0 0 0 0 0 0 0
