11
17
1
1
1
0
1
0
11
1
5
30
15
10 10 10 10 10 10 10 10 10 10 10
10 10 10 10 10 10 10 10 10 10 10
10 10 10 10 10 10 10 10 10 10 10
10 10 10 10 10 10 10 10 10 10 10
10 10 10 10 10 10 10 10 10 10 10
8 5 8 10 10 10 10 10 8 5 8
8 5 8 10 10 10 10 10 8 5 8
8 5 8 10 8 5 8 10 8 5 8
8 1 8 10 8 5 8 10 8 1 8
8 1 8 10 8 5 8 10 8 1 8
10 10 10 10 8 5 8 10 10 10 10
10 10 10 10 8 1 8 10 10 10 10
8 8 8 10 8 1 8 10 8 8 8
3 3 8 10 8 1 8 10 8 3 3
3 8 4 10 8 1 8 10 4 8 3
8 4 4 10 10 10 10 10 4 4 8
8 8 8 10 10 10 10 10 8 8 8
0 0 0 0 0 0 0 0 0 0 0
0 0 0 0 0 0 0 0 0 0 0
0 0 0 0 0 0 0 0 0 0 0
0 0 0 0 0 0 0 0 0 0 0
0 0 0 0 0 0 0 0 0 0 0
1 0 0 0 0 0 0 0 0 0 0
0 0 0 0 0 0 0 0 0 0 0
0 0 0 0 2 0 0 0 0 0 2
0 0 0 0 0 0 0 0 0 0 0
1 0 3 0 0 2 0 0 2 2 0
0 0 0 0 0 0 0 0 0 0 0
0 0 0 0 0 0 0 0 0 0 0
0 0 0 0 0 0 0 0 0 0 0
3 0 0 0 0 0 0 0 0 0 2
0 0 1 0 5 0 0 0 3 0 0
0 0 0 0 0 0 0 0 0 0 0
0 0 0 0 0 0 0 0 0 0 0
0 0 0 0 0 0 0 0 0 0 0
0 0 0 0 0 0 0 0 0 0 0
0 0 0 0 0 0 0 0 0 0 0
0 0 0 0 0 0 0 0 0 0 0
0 0 0 0 0 0 0 0 0 0 0
2 0 0 0 0 0 0 0 0 0 0
0 0 0 0 0 0 0 0 0 0 0
0 0 0 0 6 0 0 0 0 0 3
0 0 0 0 0 0 0 0 0 0 0
0 0 4 0 0 13 0 0 3 14 0
0 0 0 0 0 0 0 0 0 0 0
0 0 0 0 0 0 0 0 0 0 0
0 0 0 0 0 0 0 0 0 0 0
4 0 0 0 0 0 0 0 0 0 15
0 0 3 0 5 0 0 0 4 0 0
0 0 0 0 0 0 0 0 0 0 0
0 0 0 0 0 0 0 0 0 0 0
