11
17
1
1
0
0
0
0
13
1
5
30
15
10 10 10 10 10 10 10 10 10 10 10
10 10 10 10 10 10 10 10 10 10 10
10 10 10 10 4 4 4 10 10 10 10
10 10 10 4 4 4 4 4 10 10 10
10 10 4 4 2 2 2 4 4 10 10
10 10 4 4 2 2 2 4 4 10 10
10 4 4 2 0 0 0 2 4 4 10
10 4 2 2 0 3 0 2 2 4 10
10 4 2 0 3 10 3 0 2 4 10
4 4 2 0 3 10 3 0 2 4 4
4 2 0 3 9 10 9 3 0 2 4
4 2 0 3 10 10 10 3 0 2 4
4 2 0 3 10 10 10 3 0 2 4
4 2 0 3 10 10 10 3 0 2 4
8 8 8 8 8 10 8 8 8 8 8
10 10 10 10 10 10 10 10 10 10 10
10 10 10 10 10 10 10 10 10 10 10
0 0 0 0 0 0 0 0 0 0 0
0 0 0 0 0 0 0 0 0 0 0
0 0 0 0 0 0 0 0 0 0 0
0 0 0 0 0 0 0 0 0 0 0
0 0 0 0 0 0 0 0 0 0 0
0 0 0 0 0 0 0 0 0 0 0
0 0 0 0 0 0 0 2 0 0 0
0 0 0 0 0 0 0 0 0 0 0
0 0 0 0 0 0 0 0 0 0 0
0 0 0 1 0 0 0 0 1 0 0
0 1 0 0 0 0 0 0 0 1 0
0 0 0 0 0 0 0 0 0 0 0
2 0 0 0 0 0 0 0 0 0 0
0 0 1 0 0 0 0 1 0 0 2
0 0 0 0 0 0 0 0 0 0 0
0 0 0 0 0 0 0 0 0 0 0
0 0 0 0 0 0 0 0 0 0 0
0 0 0 0 0 0 0 0 0 0 0
0 0 0 0 0 0 0 0 0 0 0
0 0 0 0 0 0 0 0 0 0 0
0 0 0 0 0 0 0 0 0 0 0
0 0 0 0 0 0 0 0 0 0 0
0 0 0 0 0 0 0 0 0 0 0
0 0 0 0 0 0 0 4 0 0 0
0 0 0 0 0 0 0 0 0 0 0
0 0 0 0 0 0 0 0 0 0 0
0 0 0 3 0 0 0 0 2 0 0
0 4 0 0 0 0 0 0 0 2 0
0 0 0 0 0 0 0 0 0 0 0
8 0 0 0 0 0 0 0 0 0 0
0 0 1 0 0 0 0 3 0 0 10
0 0 0 0 0 0 0 0 0 0 0
0 0 0 0 0 0 0 0 0 0 0
0 0 0 0 0 0 0 0 0 0 0
