11
17
1
1
0
0
0
0
7
5
5
30
15
10 10 10 10 10 10 10 10 10 10 10
10 10 10 10 10 10 10 10 10 10 10
10 10 10 10 10 10 10 10 10 10 10
10 2 2 4 4 4 4 4 2 2 10
10 10 2 2 4 4 4 2 2 10 10
10 10 10 2 2 4 2 2 10 10 10
6 10 10 10 2 2 2 10 10 10 6
6 6 10 10 10 2 10 10 10 6 6
3 6 6 10 10 10 10 10 6 6 3
3 3 6 6 10 11 10 6 6 3 3
3 6 6 10 10 10 10 10 6 6 3
6 6 10 10 10 2 10 10 10 6 6
6 10 10 10 2 2 2 10 10 10 6
10 10 10 2 2 4 2 2 10 10 10
10 10 2 2 4 4 4 2 2 10 10
10 2 2 4 4 4 4 4 2 2 10
11 8 8 8 8 8 8 8 8 8 11
0 0 0 0 0 0 0 0 0 0 0
0 0 0 0 0 0 0 0 0 0 0
0 0 0 0 0 0 0 0 0 0 0
0 0 0 0 0 0 0 0 0 0 0
0 0 0 0 0 1 0 0 0 0 0
0 0 0 0 0 0 0 0 0 0 0
0 0 0 0 0 0 0 0 0 0 0
0 0 0 0 0 0 0 0 0 2 0
0 0 0 0 0 0 0 0 0 0 0
0 2 0 0 0 0 0 0 0 0 0
0 0 0 0 0 0 0 0 0 0 0
0 0 0 0 0 0 0 0 0 0 0
0 0 0 0 0 0 0 0 0 0 0
0 0 0 0 0 2 0 0 0 0 0
0 0 0 0 0 0 0 0 0 0 0
0 0 2 0 0 0 0 4 0 0 0
0 0 0 0 0 0 0 0 0 0 0
0 0 0 0 0 0 0 0 0 0 0
0 0 0 0 0 0 0 0 0 0 0
0 0 0 0 0 0 0 0 0 0 0
0 0 0 0 0 0 0 0 0 0 0
0 0 0 0 0 14 0 0 0 0 0
0 0 0 0 0 0 0 0 0 0 0
0 0 0 0 0 0 0 0 0 0 0
0 0 0 0 0 0 0 0 0 10 0
0 0 0 0 0 0 0 0 0 0 0
0 3 0 0 0 0 0 0 0 0 0
0 0 0 0 0 0 0 0 0 0 0
0 0 0 0 0 0 0 0 0 0 0
0 0 0 0 0 0 0 0 0 0 0
0 0 0 0 0 2 0 0 0 0 0
0 0 0 0 0 0 0 0 0 0 0
0 0 3 0 0 0 0 5 0 0 0
0 0 0 0 0 0 0 0 0 0 0
