11
17
1
1
1
0
1
0
7
2
5
30
15
10 10 10 10 10 10 10 10 10 10 10
10 10 10 10 10 10 10 10 10 10 10
10 10 10 8 8 8 10 10 10 10 10
10 10 8 3 10 3 8 10 10 10 10
10 8 6 6 6 6 6 8 10 10 10
10 8 10 3 10 3 10 8 10 10 10
10 8 6 6 6 6 6 8 10 10 10
10 8 10 3 10 3 10 8 10 10 10
10 8 6 6 6 6 6 8 10 10 10
10 8 10 3 10 3 10 8 10 10 10
10 10 8 3 10 3 8 10 10 10 10
10 10 10 8 8 8 10 10 10 10 10
10 10 10 10 8 10 10 10 9 10 10
10 10 10 10 9 10 10 9 9 9 10
10 10 10 10 9 10 10 9 9 9 10
10 10 10 10 9 10 10 10 9 10 10
10 10 10 10 10 10 10 10 10 10 10
0 0 0 0 0 0 0 0 0 0 0
0 0 0 0 0 0 0 0 0 0 0
0 0 0 0 2 0 0 0 0 0 0
0 0 0 0 0 0 2 0 0 0 0
0 0 2 0 0 0 0 1 0 0 0
0 0 0 0 0 0 0 0 0 0 0
0 0 0 0 0 0 0 0 0 0 0
0 0 0 0 0 0 0 0 0 0 0
0 2 0 0 0 2 0 0 0 0 0
0 0 0 0 0 0 0 1 0 0 0
0 0 0 0 0 2 0 0 0 0 0
0 0 0 0 1 0 0 0 0 0 0
0 0 0 0 0 0 0 0 0 0 0
0 0 0 0 0 0 0 0 0 0 0
0 0 0 0 0 0 0 0 0 0 0
0 0 0 0 0 0 0 0 0 0 0
0 0 0 0 0 0 0 0 0 0 0
0 0 0 0 0 0 0 0 0 0 0
0 0 0 0 0 0 0 0 0 0 0
0 0 0 0 5 0 0 0 0 0 0
0 0 0 0 0 0 13 0 0 0 0
0 0 3 0 0 0 0 4 0 0 0
0 0 0 0 0 0 0 0 0 0 0
0 0 0 0 0 0 0 0 0 0 0
0 0 0 0 0 0 0 0 0 0 0
0 1 0 0 0 3 0 0 0 0 0
0 0 0 0 0 0 0 4 0 0 0
0 0 0 0 0 0 0 0 0 0 0
0 0 0 0 4 0 0 0 0 0 0
0 0 0 0 0 0 0 0 0 0 0
0 0 0 0 0 0 0 0 0 0 0
0 0 0 0 0 0 0 0 0 0 0
0 0 0 0 0 0 0 0 0 0 0
0 0 0 0 0 0 0 0 0 0 0
