11
17
1
1
0
0
0
0
9
1
5
30
15
10 10 10 10 10 10 10 10 10 10 10
10 10 10 10 10 10 10 10 10 10 10
8 8 8 10 8 8 8 10 8 8 8
8 3 8 10 8 3 8 10 8 3 8
8 3 8 10 8 3 8 10 8 3 8
8 8 8 10 8 8 8 10 8 8 8
9 10 10 10 10 10 10 10 10 10 9
8 8 8 10 9 9 9 10 8 8 8
8 4 8 10 8 4 8 10 8 4 8
8 4 8 10 8 4 8 10 8 4 8
8 8 8 10 9 9 9 10 8 8 8
9 10 10 10 10 10 10 10 10 10 9
9 8 9 10 8 8 8 10 9 8 9
9 1 9 10 8 1 8 10 9 1 9
9 1 9 10 8 1 8 10 9 1 9
9 8 9 10 8 8 8 10 9 8 9
10 10 10 10 10 10 10 10 10 10 10
0 0 0 0 0 0 0 0 0 0 0
0 0 0 0 0 0 0 0 0 0 0
1 0 0 0 0 0 0 0 0 0 0
0 0 0 0 0 0 0 0 0 0 0
0 0 0 0 0 2 0 0 0 0 0
0 0 0 0 0 0 0 0 0 0 0
0 0 0 0 0 0 0 0 0 0 0
0 0 0 0 0 0 0 0 0 0 0
0 0 0 0 0 0 0 0 0 1 0
0 0 0 0 0 0 0 0 0 0 0
0 0 0 0 0 0 0 0 0 0 0
0 0 0 0 0 0 0 0 0 0 0
0 1 0 0 0 0 0 0 0 0 0
0 0 0 0 0 2 0 0 0 0 0
0 0 0 0 0 0 0 0 0 0 0
0 1 0 0 0 0 0 0 0 0 0
0 0 0 0 0 0 0 0 0 0 0
0 0 0 0 0 0 0 0 0 0 0
0 0 0 0 0 0 0 0 0 0 0
6 0 0 0 0 0 0 0 0 0 0
0 0 0 0 0 0 0 0 0 0 0
0 0 0 0 0 12 0 0 0 0 0
0 0 0 0 0 0 0 0 0 0 0
0 0 0 0 0 0 0 0 0 0 0
0 0 0 0 0 0 0 0 0 0 0
0 0 0 0 0 0 0 0 0 10 0
0 0 0 0 0 0 0 0 0 0 0
0 0 0 0 0 0 0 0 0 0 0
0 0 0 0 0 0 0 0 0 0 0
0 3 0 0 0 0 0 0 0 0 0
0 0 0 0 0 3 0 0 0 0 0
0 0 0 0 0 0 0 0 0 0 0
0 4 0 0 0 0 0 0 0 0 0
0 0 0 0 0 0 0 0 0 0 0
