11
17
1
1
0
0
0
0
4
2
5
30
15
10 10 10 10 10 10 10 10 10 10 10
10 10 10 10 10 10 10 10 10 10 10
10 10 10 10 10 10 10 10 10 10 10
10 10 10 10 10 10 10 10 10 10 10
10 10 10 10 10 10 10 10 10 10 10
9 10 9 10 10 9 10 10 9 10 9
9 8 10 8 8 10 8 8 10 8 9
9 2 9 6 6 9 6 6 9 2 9
9 2 10 6 6 10 6 6 10 2 9
9 2 9 6 6 9 6 6 9 2 9
9 2 10 6 6 10 6 6 10 2 9
9 4 10 3 3 10 3 3 10 3 9
9 4 9 3 3 9 3 3 9 4 9
9 4 10 3 3 10 3 3 10 4 9
9 4 9 3 3 9 3 3 9 4 9
9 8 10 8 8 10 8 8 10 8 9
9 10 9 10 10 9 10 10 9 10 9
0 0 0 0 0 0 0 0 0 0 0
0 0 0 0 0 0 0 0 0 0 0
0 0 0 0 0 0 0 0 0 0 0
0 0 0 0 0 0 0 0 0 0 0
0 0 0 0 0 0 0 0 0 0 0
0 0 0 0 0 0 0 0 0 0 0
0 0 0 0 0 0 0 0 0 0 0
0 0 0 0 0 0 0 0 0 0 0
0 0 0 2 0 0 0 0 0 0 0
0 0 0 0 0 0 0 0 0 0 0
0 0 0 1 0 0 0 0 0 0 0
0 0 0 0 0 0 0 0 0 0 0
0 0 0 0 2 0 0 0 0 0 0
0 2 0 0 0 0 0 0 0 2 0
0 0 0 0 0 0 0 0 0 0 0
0 0 0 0 2 0 0 2 0 0 0
0 0 0 0 0 0 0 0 0 0 0
0 0 0 0 0 0 0 0 0 0 0
0 0 0 0 0 0 0 0 0 0 0
0 0 0 0 0 0 0 0 0 0 0
0 0 0 0 0 0 0 0 0 0 0
0 0 0 0 0 0 0 0 0 0 0
0 0 0 0 0 0 0 0 0 0 0
0 0 0 0 0 0 0 0 0 0 0
0 0 0 0 0 0 0 0 0 0 0
0 0 0 6 0 0 0 0 0 0 0
0 0 0 0 0 0 0 0 0 0 0
0 0 0 3 0 0 0 0 0 0 0
0 0 0 0 0 0 0 0 0 0 0
0 0 0 0 8 0 0 0 0 0 0
0 2 0 0 0 0 0 0 0 4 0
0 0 0 0 0 0 0 0 0 0 0
0 0 0 0 3 0 0 12 0 0 0
0 0 0 0 0 0 0 0 0 0 0
