11
17
0
0
1
0
1
0
6
5
5
30
15
10 10 10 10 10 10 10 10 10 10 10
10 10 8 8 10 10 10 8 8 10 10
10 8 6 6 8 10 8 6 6 8 10
10 8 10 0 8 8 8 0 10 8 10
10 8 10 0 8 8 8 0 10 8 10
10 8 6 6 8 2 8 6 6 8 10
10 10 8 8 2 2 2 8 8 10 10
10 10 10 10 2 2 2 10 10 10 10
10 10 10 2 2 2 2 2 10 10 10
10 10 10 2 2 2 2 2 10 10 10
10 10 10 2 9 2 9 2 10 10 10
10 10 10 10 10 10 10 10 10 10 10
10 10 10 10 10 10 10 10 10 10 10
10 10 4 4 4 4 4 4 4 10 10
10 4 0 0 0 0 0 0 0 4 10
10 4 0 0 0 0 0 0 0 4 10
10 10 10 10 10 10 10 10 10 10 10
0 0 0 0 0 0 0 0 0 0 0
0 0 0 0 0 0 0 0 0 0 0
0 2 0 0 0 0 0 0 0 0 0
0 0 0 0 0 0 0 0 0 0 0
0 0 0 0 0 0 0 0 0 0 0
0 0 0 0 0 0 0 0 0 0 0
0 0 0 0 0 0 0 0 2 0 0
0 0 0 0 0 0 0 0 0 0 0
0 0 0 2 0 0 0 0 0 0 0
0 0 0 0 0 0 0 1 0 0 0
0 0 0 0 0 0 0 0 0 0 0
0 0 0 0 0 0 0 0 0 0 0
0 0 0 0 0 0 0 0 0 0 0
0 0 0 0 0 2 0 1 0 0 0
0 2 2 0 0 0 0 2 0 0 0
0 0 0 0 2 0 0 0 0 0 0
0 0 0 0 0 0 0 0 0 0 0
0 0 0 0 0 0 0 0 0 0 0
0 0 0 0 0 0 0 0 0 0 0
0 6 0 0 0 0 0 0 0 0 0
0 0 0 0 0 0 0 0 0 0 0
0 0 0 0 0 0 0 0 0 0 0
0 0 0 0 0 0 0 0 0 0 0
0 0 0 0 0 0 0 0 3 0 0
0 0 0 0 0 0 0 0 0 0 0
0 0 0 12 0 0 0 0 0 0 0
0 0 0 0 0 0 0 10 0 0 0
0 0 0 0 0 0 0 0 0 0 0
0 0 0 0 0 0 0 0 0 0 0
0 0 0 0 0 0 0 0 0 0 0
0 0 0 0 0 4 0 0 0 0 0
0 3 4 0 0 0 0 2 0 0 0
0 0 0 0 2 0 0 0 0 0 0
0 0 0 0 0 0 0 0 0 0 0
