11
17
1
1
1
1
1
1
7
4
5
4
8
10 10 10 10 10 10 10 10 10 10 10
10 10 10 10 10 10 10 10 10 10 10
10 10 10 10 10 10 10 10 10 10 10
10 10 9 10 10 10 9 10 10 10 10
10 10 9 0 0 0 9 10 10 10 10
10 10 9 0 0 0 9 8 10 10 10
10 10 9 1 1 1 9 10 8 10 10
10 10 9 1 1 1 9 10 8 10 10
10 10 9 1 1 1 9 10 8 10 10
10 10 9 1 1 1 9 10 8 10 10
10 10 9 1 1 1 9 10 8 10 10
10 10 9 1 1 1 9 8 10 10 10
10 10 9 2 2 2 9 10 10 10 10
10 10 9 2 2 2 9 10 10 10 10
10 10 9 8 9 8 9 10 10 10 10
10 10 10 10 10 10 10 10 10 10 10
10 10 10 10 10 10 10 10 10 10 10
0 0 0 0 0 0 0 0 0 0 0
0 0 0 0 0 0 0 0 0 0 0
0 0 0 0 0 0 0 0 0 0 0
0 0 0 0 0 0 0 0 0 0 0
0 0 0 2 0 0 0 0 0 0 0
0 0 0 0 0 0 0 0 0 0 0
0 0 0 0 0 1 0 0 0 0 0
0 0 0 1 0 0 0 0 0 0 0
0 0 0 0 0 0 0 0 0 0 0
0 0 0 0 0 0 0 0 0 0 0
0 0 0 3 0 0 0 0 0 0 0
0 0 0 0 0 0 0 1 0 0 0
0 0 0 0 0 2 0 0 0 0 0
0 0 0 0 0 0 0 0 0 0 0
0 0 0 0 0 0 0 0 0 0 0
0 0 0 0 0 0 0 0 0 0 0
0 0 0 0 0 0 0 0 0 0 0
0 0 0 0 0 0 0 0 0 0 0
0 0 0 0 0 0 0 0 0 0 0
0 0 0 0 0 0 0 0 0 0 0
0 0 0 0 0 0 0 0 0 0 0
0 0 0 3 0 0 0 0 0 0 0
0 0 0 0 0 0 0 0 0 0 0
0 0 0 0 0 4 0 0 0 0 0
0 0 0 13 0 0 0 0 0 0 0
0 0 0 0 0 0 0 0 0 0 0
0 0 0 0 0 0 0 0 0 0 0
0 0 0 8 0 0 0 0 0 0 0
0 0 0 0 0 0 0 3 0 0 0
0 0 0 0 0 13 0 0 0 0 0
0 0 0 0 0 0 0 0 0 0 0
0 0 0 0 0 0 0 0 0 0 0
0 0 0 0 0 0 0 0 0 0 0
0 0 0 0 0 0 0 0 0 0 0
