11
17
1
1
0
1
1
0
1
2
5
30
15
10 10 10 10 10 10 10 10 10 10 10
10 10 10 10 10 10 10 10 10 10 10
10 10 10 10 10 10 10 10 10 10 10
10 10 10 9 9 9 9 9 9 9 10
10 10 10 10 10 10 10 10 10 9 10
10 10 10 10 8 8 8 8 10 9 10
10 10 10 10 10 10 10 10 10 9 10
10 9 9 9 9 9 9 10 10 9 10
10 9 10 10 10 10 10 10 10 9 10
10 9 10 2 4 2 4 2 10 9 10
10 9 10 10 10 10 10 10 10 9 10
10 9 8 8 8 9 9 9 9 9 10
10 9 10 10 10 10 10 10 10 10 10
10 9 10 8 8 8 8 10 10 10 10
10 9 10 10 10 10 10 10 10 10 10
10 9 9 9 9 9 9 9 10 10 10
10 10 10 10 10 10 10 10 10 10 10
0 0 0 0 0 0 0 0 0 0 0
0 0 0 0 0 0 0 0 0 0 0
0 0 0 0 0 0 0 0 0 0 0
0 0 0 0 0 0 0 0 0 0 0
0 0 0 0 0 0 0 0 0 0 0
0 0 0 0 1 0 0 3 0 0 0
0 0 0 0 0 0 0 0 0 0 0
0 0 0 0 0 0 0 0 0 0 0
0 0 0 0 0 0 0 0 0 0 0
0 0 0 1 0 2 1 2 0 0 0
0 0 0 0 0 0 0 0 0 0 0
0 0 0 2 0 0 0 0 0 0 0
0 0 0 0 0 0 0 0 0 0 0
0 0 0 3 0 2 0 0 0 0 0
0 0 0 0 0 0 0 0 0 0 0
0 0 0 0 0 0 0 0 0 0 0
0 0 0 0 0 0 0 0 0 0 0
0 0 0 0 0 0 0 0 0 0 0
0 0 0 0 0 0 0 0 0 0 0
0 0 0 0 0 0 0 0 0 0 0
0 0 0 0 0 0 0 0 0 0 0
0 0 0 0 0 0 0 0 0 0 0
0 0 0 0 3 0 0 5 0 0 0
0 0 0 0 0 0 0 0 0 0 0
0 0 0 0 0 0 0 0 0 0 0
0 0 0 0 0 0 0 0 0 0 0
0 0 0 2 0 13 1 10 0 0 0
0 0 0 0 0 0 0 0 0 0 0
0 0 0 12 0 0 0 0 0 0 0
0 0 0 0 0 0 0 0 0 0 0
0 0 0 13 0 3 0 0 0 0 0
0 0 0 0 0 0 0 0 0 0 0
0 0 0 0 0 0 0 0 0 0 0
0 0 0 0 0 0 0 0 0 0 0
