11
17
1
1
0
0
0
0
7
1
5
30
15
10 10 10 10 10 10 10 10 10 10 10
10 10 10 10 10 10 10 10 10 10 10
10 9 9 9 4 4 4 9 9 9 10
10 9 9 4 0 0 0 4 9 9 10
10 9 4 0 0 0 0 0 4 9 10
10 9 4 0 0 0 0 0 4 9 10
10 9 4 0 0 0 0 0 4 9 10
10 9 4 0 0 0 0 0 4 9 10
10 9 9 4 0 0 0 4 9 9 10
10 9 9 9 4 4 4 9 9 9 10
10 9 9 9 9 4 9 9 9 9 10
10 9 9 9 9 4 9 9 9 9 10
10 9 4 4 4 4 4 4 4 9 10
10 9 9 9 9 4 9 9 9 9 10
10 9 9 9 9 4 9 9 9 9 10
10 9 9 9 9 4 9 9 9 9 10
10 9 9 9 9 10 9 9 9 9 10
0 0 0 0 0 0 0 0 0 0 0
0 0 0 0 0 0 0 0 0 0 0
0 0 0 0 1 0 0 0 0 0 0
0 0 0 0 0 0 3 0 0 0 0
0 0 0 1 0 0 0 0 0 0 0
0 0 0 0 0 0 0 0 1 0 0
0 0 0 0 0 0 0 0 0 0 0
0 0 0 0 0 0 0 0 0 0 0
0 0 0 0 0 0 0 0 0 0 0
0 0 0 0 0 0 0 0 0 0 0
0 0 0 0 0 1 0 0 0 0 0
0 0 0 0 0 0 0 0 0 0 0
0 0 1 0 0 2 0 0 0 0 0
0 0 0 0 0 0 0 0 0 0 0
0 0 0 0 0 0 0 0 0 0 0
0 0 0 0 0 3 0 0 0 0 0
0 0 0 0 0 0 0 0 0 0 0
0 0 0 0 0 0 0 0 0 0 0
0 0 0 0 0 0 0 0 0 0 0
0 0 0 0 13 0 0 0 0 0 0
0 0 0 0 0 0 3 0 0 0 0
0 0 0 6 0 0 0 0 0 0 0
0 0 0 0 0 0 0 0 5 0 0
0 0 0 0 0 0 0 0 0 0 0
0 0 0 0 0 0 0 0 0 0 0
0 0 0 0 0 0 0 0 0 0 0
0 0 0 0 0 0 0 0 0 0 0
0 0 0 0 0 3 0 0 0 0 0
0 0 0 0 0 0 0 0 0 0 0
0 0 8 0 0 3 0 0 0 0 0
0 0 0 0 0 0 0 0 0 0 0
0 0 0 0 0 0 0 0 0 0 0
0 0 0 0 0 8 0 0 0 0 0
0 0 0 0 0 0 0 0 0 0 0
