11
17
1
1
0
0
0
0
7
1
5
15
30
10 10 10 10 10 10 10 10 10 10 10
10 10 10 10 10 10 10 10 10 10 10
2 10 10 10 10 10 10 10 10 10 10
2 6 10 10 10 10 10 10 10 10 10
2 6 5 10 10 10 10 10 10 10 10
2 6 5 3 10 10 10 10 10 10 10
2 6 5 3 4 10 10 10 10 10 10
2 6 5 3 4 2 10 10 10 10 10
2 6 5 3 4 2 6 10 10 10 10
2 6 5 3 4 2 6 5 10 10 10
2 6 5 3 4 2 6 5 3 10 10
2 6 5 3 4 2 6 5 3 4 10
8 8 8 8 8 8 8 8 8 8 2
10 10 10 10 10 10 10 10 10 10 10
10 10 10 10 10 10 10 10 10 10 10
10 10 10 10 10 10 10 10 10 10 10
10 10 10 10 10 10 10 10 10 10 10
10 10 10 10 10 10 10 10 10 10 10
0 0 0 0 0 0 0 0 0 0 0
0 0 0 0 0 0 0 0 0 0 0
0 0 0 0 0 0 0 0 0 0 0
0 0 0 0 0 0 0 0 0 0 0
0 0 0 0 0 0 0 0 0 0 0
0 0 0 0 0 0 0 0 0 0 0
2 0 1 0 0 0 0 0 0 0 0
2 0 0 0 0 0 0 0 0 0 0
0 0 0 1 0 0 0 0 0 0 0
0 0 0 0 0 0 1 0 0 0 0
0 2 0 0 0 0 0 0 0 0 0
0 0 0 0 0 0 2 0 2 0 0
0 0 0 0 0 0 0 0 0 0 0
0 0 0 0 0 0 0 0 0 0 0
0 0 0 0 0 0 0 0 0 0 0
0 0 0 0 0 0 0 0 0 0 0
0 0 0 0 0 0 0 0 0 0 0
0 0 0 0 0 0 0 0 0 0 0
0 0 0 0 0 0 0 0 0 0 0
0 0 0 0 0 0 0 0 0 0 0
0 0 0 0 0 0 0 0 0 0 0
0 0 0 0 0 0 0 0 0 0 0
0 0 0 0 0 0 0 0 0 0 0
0 0 4 0 0 0 0 0 0 0 0
5 0 0 0 0 0 0 0 0 0 0
0 0 0 1 0 0 0 0 0 0 0
0 0 0 0 0 0 9 0 0 0 0
0 6 0 0 0 0 0 0 0 0 0
0 0 0 0 0 0 3 0 8 0 0
0 0 0 0 0 0 0 0 0 0 0
0 0 0 0 0 0 0 0 0 0 0
0 0 0 0 0 0 0 0 0 0 0
0 0 0 0 0 0 0 0 0 0 0
