11
17
1
1
0
0
0
0
3
2
5
30
15
10 10 10 10 10 10 10 10 10 10 10
10 10 10 10 10 10 10 10 10 10 10
5 5 5 5 5 5 5 5 5 5 5
10 10 10 10 10 10 10 10 10 10 10
0 0 0 9 9 9 9 9 9 9 9
10 10 10 10 10 10 10 10 10 10 10
4 4 4 4 4 4 4 4 4 4 4
10 10 10 10 10 10 10 10 10 10 10
9 9 9 9 9 9 9 9 0 0 0
10 10 10 10 10 10 10 10 10 10 10
2 2 2 2 2 2 2 2 2 2 2
10 10 10 10 10 10 10 10 10 10 10
3 3 3 9 9 9 9 9 9 9 9
10 10 10 10 10 10 10 10 10 10 10
3 3 3 3 3 3 3 3 3 3 3
10 10 10 10 10 10 10 10 10 10 10
9 9 9 9 9 9 9 9 3 3 3
10 10 10 10 10 10 10 10 10 10 10
0 0 0 0 0 0 0 0 0 0 0
0 0 0 0 0 0 0 0 0 0 0
0 0 0 0 0 0 0 0 0 0 0
0 0 4 0 0 0 0 0 0 0 0
0 0 0 0 0 0 0 0 0 0 0
0 0 0 0 0 2 0 0 0 0 0
0 0 0 0 0 0 0 0 0 0 0
0 0 0 0 0 0 0 0 0 0 0
0 0 0 0 0 0 0 0 0 0 0
0 0 0 0 2 0 0 0 2 0 0
0 0 0 0 0 0 0 0 0 0 0
0 0 1 0 0 0 0 0 0 0 0
0 0 0 0 0 0 0 0 0 0 0
0 0 2 0 3 0 1 0 2 0 0
0 0 0 0 0 0 0 0 0 0 0
0 0 0 0 0 0 0 0 0 0 0
0 0 0 0 0 0 0 0 0 0 0
0 0 0 0 0 0 0 0 0 0 0
0 0 0 0 0 0 0 0 0 0 0
0 0 0 0 0 0 0 0 0 0 0
0 0 6 0 0 0 0 0 0 0 0
0 0 0 0 0 0 0 0 0 0 0
0 0 0 0 0 3 0 0 0 0 0
0 0 0 0 0 0 0 0 0 0 0
0 0 0 0 0 0 0 0 0 0 0
0 0 0 0 0 0 0 0 0 0 0
0 0 0 0 2 0 0 0 8 0 0
0 0 0 0 0 0 0 0 0 0 0
0 0 9 0 0 0 0 0 0 0 0
0 0 0 0 0 0 0 0 0 0 0
0 0 0 0 1 0 0 0 9 0 0
0 0 0 0 0 0 0 0 0 0 0
0 0 0 0 0 0 0 0 0 0 0
