11
17
1
1
0
0
0
0
6
3
5
55
35
10 10 10 10 10 10 10 10 10 10 10
10 10 10 10 10 10 10 10 10 10 10
3 10 4 10 5 10 5 10 4 10 3
3 10 4 10 5 10 5 10 4 10 3
3 10 4 10 5 10 5 10 4 10 3
3 10 9 2 9 2 9 2 9 10 3
3 10 4 10 5 10 5 10 4 10 3
3 10 4 10 5 10 5 10 4 10 3
3 10 4 10 5 10 5 10 4 10 3
3 10 4 10 5 10 5 10 4 10 3
3 10 4 10 5 10 5 10 4 10 3
2 10 9 10 9 10 9 10 9 10 2
3 10 4 10 5 10 5 10 4 10 3
10 10 10 10 10 10 10 10 10 10 10
10 10 10 10 10 10 10 10 10 10 10
10 10 10 10 10 10 10 10 10 10 10
10 10 10 10 10 10 10 10 10 10 10
0 0 0 0 0 0 0 0 0 0 0
0 0 0 0 0 0 0 0 0 0 0
0 0 0 0 0 0 0 0 0 0 2
0 0 0 0 0 0 0 0 1 0 0
0 0 0 0 0 0 0 0 0 0 0
0 0 0 3 0 0 0 1 0 0 0
0 0 0 0 0 0 0 0 0 0 0
0 0 0 0 0 0 2 0 0 0 0
2 0 2 0 2 0 0 0 0 0 2
0 0 0 0 1 0 0 0 0 0 0
0 0 0 0 0 0 2 0 0 0 0
1 0 0 0 0 0 0 0 0 0 2
0 0 0 0 0 0 0 0 0 0 0
0 0 0 0 0 0 0 0 0 0 0
0 0 0 0 0 0 0 0 0 0 0
0 0 0 0 0 0 0 0 0 0 0
0 0 0 0 0 0 0 0 0 0 0
0 0 0 0 0 0 0 0 0 0 0
0 0 0 0 0 0 0 0 0 0 0
0 0 0 0 0 0 0 0 0 0 6
0 0 0 0 0 0 0 0 2 0 0
0 0 5 0 0 0 0 0 0 0 0
0 0 0 9 0 0 0 4 0 0 0
0 0 0 0 0 0 0 0 0 0 0
0 0 0 0 0 0 1 0 0 0 0
7 0 3 0 4 0 0 0 0 0 3
0 0 0 0 0 0 0 0 0 0 0
0 0 0 0 0 0 0 0 0 0 0
3 0 0 0 0 0 0 0 0 0 2
0 0 0 0 0 0 0 0 0 0 0
0 0 0 0 0 0 0 0 0 0 0
0 0 0 0 0 0 0 0 0 0 0
0 0 0 0 0 0 0 0 0 0 0
0 0 0 0 0 0 0 0 0 0 0
