11
17
1
1
1
1
1
1
5
1
6
50
25
10 10 10 10 10 10 10 10 10 10 10
10 10 10 10 10 10 10 10 10 10 10
10 10 10 10 7 6 7 10 10 10 10
10 10 10 7 5 3 6 7 10 10 10
10 10 10 6 3 5 7 2 10 10 10
10 10 5 3 6 7 5 4 2 10 10
10 10 3 5 7 2 4 5 7 10 10
10 10 6 7 5 4 2 7 5 10 10
10 10 7 2 4 5 7 6 3 10 10
10 10 5 4 2 7 5 3 6 10 10
10 10 4 5 7 6 3 5 7 10 10
10 10 10 7 5 3 6 7 10 10 10
10 10 10 6 3 5 7 2 10 10 10
10 10 10 10 6 7 5 10 10 10 10
10 10 10 10 10 10 10 10 10 10 10
10 10 10 10 10 10 10 10 10 10 10
10 10 10 10 10 10 10 10 10 10 10
0 0 0 0 0 0 0 0 0 0 0
0 0 0 0 0 0 0 0 0 0 0
0 0 0 0 0 0 0 0 0 0 0
0 0 0 1 0 0 1 0 0 0 0
0 0 0 0 0 2 0 0 0 0 0
0 0 0 0 2 0 0 0 1 0 0
0 0 2 0 0 0 0 0 0 0 0
0 0 0 0 0 1 0 0 0 0 0
0 0 0 0 0 0 0 0 0 0 0
0 0 0 0 0 0 0 1 0 0 0
0 0 0 0 2 0 0 0 0 0 0
0 0 0 0 0 0 1 0 0 0 0
0 0 0 0 0 0 0 0 0 0 0
0 0 0 0 0 0 0 0 0 0 0
0 0 0 0 0 0 0 0 0 0 0
0 0 0 0 0 0 0 0 0 0 0
0 0 0 0 0 0 0 0 0 0 0
0 0 0 0 0 0 0 0 0 0 0
0 0 0 0 0 0 0 0 0 0 0
0 0 0 0 0 0 0 0 0 0 0
0 0 0 2 0 0 4 0 0 0 0
0 0 0 0 0 8 0 0 0 0 0
0 0 0 0 0 0 0 0 1 0 0
0 0 3 0 4 0 0 0 0 0 0
0 0 0 0 0 6 0 0 0 0 0
0 0 0 0 0 0 0 0 0 0 0
0 0 0 0 0 0 0 2 0 0 0
0 0 0 0 1 0 0 0 0 0 0
0 0 0 0 0 0 7 0 0 0 0
0 0 0 0 0 0 0 0 0 0 0
0 0 0 0 0 0 0 0 0 0 0
0 0 0 0 0 0 0 0 0 0 0
0 0 0 0 0 0 0 0 0 0 0
0 0 0 0 0 0 0 0 0 0 0
