11
17
1
1
0
0
0
0
14
1
7
30
15
10 8 10 10 10 10 10 10 10 10 10
10 10 10 10 10 10 10 10 10 10 10
10 9 10 10 10 10 10 10 10 10 10
10 9 10 10 10 10 10 10 10 10 10
10 9 10 10 10 10 3 10 10 10 10
10 9 10 10 10 3 6 3 10 10 10
10 9 10 10 3 6 3 6 3 10 10
10 9 10 3 6 3 8 3 6 3 10
10 9 10 10 3 6 3 6 3 10 10
10 9 10 10 10 3 6 3 10 10 10
10 9 10 10 10 10 3 10 10 10 10
10 9 10 10 10 10 10 10 10 10 10
10 9 10 10 10 10 10 10 10 10 10
10 9 10 10 10 10 10 10 10 10 10
10 9 10 10 10 10 10 10 10 10 10
10 9 10 10 10 10 10 10 10 10 10
10 9 9 9 9 9 9 9 9 9 9
0 0 0 0 0 0 0 0 0 0 0
0 0 0 0 0 0 0 0 0 0 0
0 0 0 0 0 0 0 0 0 0 0
0 0 0 0 0 0 0 0 0 0 0
0 0 0 0 0 0 0 0 0 0 0
0 0 0 0 0 0 0 0 0 0 0
0 0 0 0 0 0 0 0 0 0 0
0 0 0 0 0 0 0 0 0 0 0
0 0 0 0 0 0 0 0 0 0 0
0 0 0 0 0 0 0 0 0 0 0
0 0 0 0 0 0 0 0 0 0 0
0 0 0 0 0 0 0 0 0 0 0
0 0 0 0 0 0 0 0 0 0 0
0 0 0 0 0 0 0 0 0 0 0
0 0 0 0 0 0 0 0 0 0 0
0 0 0 0 0 0 0 0 0 0 0
0 0 0 0 0 0 0 0 0 0 0
0 0 0 0 0 0 0 0 0 0 0
0 0 0 0 0 0 0 0 0 0 0
0 0 0 0 0 0 0 0 0 0 0
0 0 0 0 0 0 0 0 0 0 0
0 0 0 0 0 0 0 0 0 0 0
0 0 0 0 0 0 0 0 0 0 0
0 0 0 0 0 0 0 0 0 0 0
0 0 0 0 0 0 0 0 0 0 0
0 0 0 0 0 0 0 0 0 0 0
0 0 0 0 0 0 0 0 0 0 0
0 0 0 0 0 0 0 0 0 0 0
0 0 0 0 0 0 0 0 0 0 0
0 0 0 0 0 0 0 0 0 0 0
0 0 0 0 0 0 0 0 0 0 0
0 0 0 0 0 0 0 0 0 0 0
0 0 0 0 0 0 0 0 0 0 0
0 0 0 0 0 0 0 0 0 0 0
