11
17
1
1
0
1
0
1
10
1
6
30
15
10 10 10 10 10 10 10 10 10 10 10
10 10 10 10 10 10 10 10 10 10 10
10 10 10 10 10 10 10 10 10 10 10
10 8 8 8 8 8 8 8 8 8 10
10 8 10 10 10 10 10 10 10 8 10
10 8 10 8 8 8 8 8 10 8 10
10 8 10 8 10 10 10 8 10 8 10
10 8 10 8 10 8 10 8 10 8 10
10 8 10 8 10 10 10 8 10 8 10
10 8 10 8 8 8 8 8 10 8 10
10 8 10 10 10 10 10 10 10 8 10
10 8 8 8 8 8 8 8 8 8 10
10 10 10 10 10 10 10 10 10 10 10
10 10 10 10 10 10 10 10 10 10 10
10 10 10 10 10 10 10 10 10 10 10
10 10 10 10 10 10 10 10 10 10 10
10 10 10 10 10 10 10 10 10 10 10
0 0 0 0 0 0 0 0 0 0 0
0 0 0 0 0 0 0 0 0 0 0
0 0 0 0 0 0 0 0 0 0 0
0 0 0 0 0 0 0 0 0 2 0
0 1 0 0 0 0 0 0 0 0 0
0 0 0 1 0 0 1 0 0 0 0
0 0 0 0 0 0 0 0 0 0 0
0 1 0 2 0 2 0 0 0 0 0
0 0 0 0 0 0 0 0 0 2 0
0 0 0 0 0 2 0 2 0 0 0
0 0 0 0 0 0 0 0 0 0 0
0 2 0 1 0 0 1 3 0 0 0
0 0 0 0 0 0 0 0 0 0 0
0 0 0 0 0 0 0 0 0 0 0
0 0 0 0 0 0 0 0 0 0 0
0 0 0 0 0 0 0 0 0 0 0
0 0 0 0 0 0 0 0 0 0 0
0 0 0 0 0 0 0 0 0 0 0
0 0 0 0 0 0 0 0 0 0 0
0 0 0 0 0 0 0 0 0 0 0
0 0 0 0 0 0 0 0 0 3 0
0 2 0 0 0 0 0 0 0 0 0
0 0 0 7 0 0 4 0 0 0 0
0 0 0 0 0 0 0 0 0 0 0
0 3 0 5 0 6 0 0 0 0 0
0 0 0 0 0 0 0 0 0 2 0
0 0 0 0 0 3 0 9 0 0 0
0 0 0 0 0 0 0 0 0 0 0
0 4 0 2 0 0 0 1 0 0 0
0 0 0 0 0 0 0 0 0 0 0
0 0 0 0 0 0 0 0 0 0 0
0 0 0 0 0 0 0 0 0 0 0
0 0 0 0 0 0 0 0 0 0 0
0 0 0 0 0 0 0 0 0 0 0
