11
17
1
1
1
1
1
1
9
0
5
30
15
10 10 10 10 10 10 10 10 10 10 10
10 10 10 10 10 10 10 10 10 10 10
10 10 10 10 10 10 10 10 10 10 10
10 7 7 10 0 0 0 10 7 7 10
10 0 0 10 7 7 7 10 0 0 10
10 3 3 10 4 4 4 10 3 3 10
10 2 2 10 5 5 5 10 2 2 10
10 5 5 10 2 2 2 10 5 5 10
10 4 4 10 3 3 3 10 4 4 10
10 7 7 10 0 0 0 10 7 7 10
10 0 0 10 7 7 7 10 0 0 10
10 10 10 10 10 10 10 10 10 10 10
10 10 10 10 10 10 10 10 10 10 10
10 10 10 10 10 10 10 10 10 10 10
10 10 10 10 10 10 10 10 10 10 10
10 10 10 10 10 10 10 10 10 10 10
10 10 10 10 10 10 10 10 10 10 10
0 0 0 0 0 0 0 0 0 0 0
0 0 0 0 0 0 0 0 0 0 0
0 0 0 0 0 0 0 0 0 0 0
0 0 0 0 1 0 0 0 0 2 0
0 0 0 0 0 0 0 0 0 0 0
0 0 2 0 0 0 1 0 0 0 0
0 0 0 0 0 0 0 0 2 0 0
0 0 0 0 2 0 0 0 0 1 0
0 0 0 0 0 0 0 0 1 0 0
0 0 0 0 0 0 0 0 0 0 0
0 0 1 0 0 0 0 0 0 0 0
0 0 0 0 0 0 0 0 0 0 0
0 0 0 0 0 0 0 0 0 0 0
0 0 0 0 0 0 0 0 0 0 0
0 0 0 0 0 0 0 0 0 0 0
0 0 0 0 0 0 0 0 0 0 0
0 0 0 0 0 0 0 0 0 0 0
0 0 0 0 0 0 0 0 0 0 0
0 0 0 0 0 0 0 0 0 0 0
0 0 0 0 0 0 0 0 0 0 0
0 0 0 0 6 0 0 0 0 8 0
0 0 0 0 0 0 0 0 0 0 0
0 0 5 0 0 0 2 0 0 0 0
0 0 0 0 0 0 0 0 3 0 0
0 0 0 0 2 0 0 0 0 0 0
0 0 0 0 0 0 0 0 4 0 0
0 0 0 0 0 0 0 0 0 0 0
0 0 1 0 0 0 0 0 0 0 0
0 0 0 0 0 0 0 0 0 0 0
0 0 0 0 0 0 0 0 0 0 0
0 0 0 0 0 0 0 0 0 0 0
0 0 0 0 0 0 0 0 0 0 0
0 0 0 0 0 0 0 0 0 0 0
0 0 0 0 0 0 0 0 0 0 0
