11
17
1
1
0
0
0
0
5
1
5
30
15
10 10 10 10 10 10 10 10 10 10 10
10 10 10 10 10 10 10 10 10 10 10
6 8 8 6 6 6 6 6 8 8 6
6 8 7 8 6 6 6 8 5 8 6
6 8 7 7 8 8 8 5 5 8 6
6 8 7 7 7 8 5 5 5 8 6
6 8 7 7 7 8 5 5 5 8 6
6 8 7 7 7 8 5 5 5 8 6
6 8 7 7 7 8 5 5 5 8 6
6 8 7 7 7 8 5 5 5 8 6
6 8 7 7 7 8 5 5 5 8 6
6 6 8 7 7 8 5 5 8 6 6
6 6 6 8 7 8 5 8 6 6 6
6 6 6 6 8 8 8 6 6 6 6
10 10 10 10 10 10 10 10 10 10 10
10 10 10 10 10 10 10 10 10 10 10
10 10 10 10 10 10 10 10 10 10 10
0 0 0 0 0 0 0 0 0 0 0
0 0 0 0 0 0 0 0 0 0 0
0 0 0 0 0 0 0 0 0 0 0
0 0 0 0 0 0 0 0 0 0 0
0 0 2 0 0 0 0 0 0 0 1
0 1 0 0 0 0 0 0 0 0 0
0 0 0 1 0 0 0 0 0 0 0
0 0 0 0 0 0 0 1 0 1 0
0 0 1 0 0 0 0 0 0 0 0
0 0 0 0 0 0 0 0 0 0 0
0 0 0 0 0 0 0 0 0 0 0
0 0 0 0 0 0 0 0 0 0 0
0 0 0 0 0 0 0 0 0 0 0
0 3 0 1 0 2 1 0 0 2 0
0 0 0 0 0 0 0 0 0 0 0
0 0 0 0 0 0 0 0 0 0 0
0 0 0 0 0 0 0 0 0 0 0
0 0 0 0 0 0 0 0 0 0 0
0 0 0 0 0 0 0 0 0 0 0
0 0 0 0 0 0 0 0 0 0 0
0 0 0 0 0 0 0 0 0 0 0
0 0 1 0 0 0 0 0 0 0 2
0 9 0 0 0 0 0 0 0 0 0
0 0 0 2 0 0 0 0 3 0 0
0 0 0 0 0 0 0 0 0 4 0
0 0 0 0 0 0 0 0 0 0 0
0 0 0 0 0 0 0 0 0 0 0
0 0 0 0 0 0 0 3 0 0 0
7 0 0 0 0 0 0 0 0 0 0
0 0 0 0 0 0 0 0 0 0 0
0 8 0 2 0 4 0 0 0 3 0
0 0 0 0 0 0 0 0 0 0 0
0 0 0 0 0 0 0 0 0 0 0
0 0 0 0 0 0 0 0 0 0 0
