11
17
1
1
1
1
1
1
4
1
5
30
15
10 10 10 10 10 10 10 10 10 10 10
10 10 10 10 10 10 10 10 10 10 10
10 10 10 10 10 10 10 10 10 10 10
10 10 9 9 9 9 9 9 9 10 10
10 10 5 4 3 9 3 4 5 10 10
10 10 5 4 3 9 3 4 5 10 10
10 10 5 4 3 9 3 4 5 10 10
10 10 5 4 3 9 3 4 5 10 10
10 10 5 4 3 9 3 4 5 10 10
10 10 5 4 3 9 3 4 5 10 10
10 10 5 4 3 9 3 4 5 10 10
10 10 9 9 9 9 9 9 9 10 10
10 10 10 10 10 10 10 10 10 10 10
10 10 10 10 10 10 10 10 10 10 10
10 10 10 10 10 10 10 10 10 10 10
10 10 10 10 10 10 10 10 10 10 10
10 10 10 10 10 10 10 10 10 10 10
0 0 0 0 0 0 0 0 0 0 0
0 0 0 0 0 0 0 0 0 0 0
0 0 0 0 0 0 0 0 0 0 0
0 0 0 0 0 0 0 0 0 0 0
0 0 0 0 0 0 0 0 1 0 0
0 0 0 1 0 0 0 0 1 0 0
0 0 0 0 0 0 0 0 0 0 0
0 0 1 0 1 0 0 0 2 0 0
0 0 0 0 0 0 1 0 0 0 0
0 0 0 0 0 0 2 0 1 0 0
0 0 0 0 1 0 0 0 0 0 0
0 0 0 0 0 0 0 0 0 0 0
0 0 0 0 0 0 0 0 0 0 0
0 0 0 0 0 0 0 0 0 0 0
0 0 0 0 0 0 0 0 0 0 0
0 0 0 0 0 0 0 0 0 0 0
0 0 0 0 0 0 0 0 0 0 0
0 0 0 0 0 0 0 0 0 0 0
0 0 0 0 0 0 0 0 0 0 0
0 0 0 0 0 0 0 0 0 0 0
0 0 0 0 0 0 0 0 0 0 0
0 0 0 0 0 0 0 0 0 0 0
0 0 0 2 0 0 0 6 2 0 0
0 0 0 0 0 0 0 0 0 0 0
0 0 7 0 3 0 0 5 2 0 0
0 0 0 0 0 0 8 0 0 0 0
0 0 0 0 0 0 3 0 2 0 0
0 0 0 0 1 0 0 0 0 0 0
0 0 0 0 0 0 0 0 0 0 0
0 0 0 0 0 0 0 0 0 0 0
0 0 0 0 0 0 0 0 0 0 0
0 0 0 0 0 0 0 0 0 0 0
0 0 0 0 0 0 0 0 0 0 0
0 0 0 0 0 0 0 0 0 0 0
