11
17
1
1
1
1
1
1
5
0
5
30
15
10 10 10 10 10 10 10 10 10 0 10
10 10 10 10 10 10 10 10 10 0 0
10 10 10 0 0 0 0 10 10 10 10
10 10 10 10 0 0 0 0 10 10 10
10 10 10 10 10 9 9 9 10 10 10
10 10 0 10 10 10 10 10 10 10 10
10 0 7 0 10 10 10 10 10 10 10
0 7 9 7 0 10 10 10 10 10 10
10 0 7 0 10 10 10 10 10 10 10
10 10 0 10 10 10 10 10 10 10 7
10 10 2 10 10 9 10 5 5 5 10
5 10 2 10 5 10 5 10 5 2 5
9 5 2 5 10 2 5 9 5 10 10
9 5 2 5 10 5 10 7 5 5 10
9 9 5 9 5 10 10 5 5 10 10
10 10 10 10 10 10 10 10 10 10 10
10 10 10 10 10 10 10 10 10 10 10
0 0 0 0 0 0 0 0 0 0 0
0 0 0 0 0 0 0 0 0 0 0
0 0 0 2 0 0 2 0 0 0 0
0 0 0 0 0 0 0 0 0 0 0
0 0 0 0 0 0 0 0 0 0 0
0 0 0 0 0 0 0 0 0 0 0
0 0 0 0 0 0 0 0 0 0 0
0 0 0 0 2 0 0 0 0 0 0
0 0 0 0 0 0 0 0 0 0 0
0 0 0 0 0 0 0 0 0 0 0
0 0 0 0 0 0 0 1 1 0 0
0 0 0 0 0 0 0 0 0 0 0
0 2 1 0 0 0 2 0 0 0 0
0 0 0 0 0 0 0 0 0 0 0
0 0 0 0 0 0 0 0 0 0 0
0 0 0 0 0 0 0 0 0 0 0
0 0 0 0 0 0 0 0 0 0 0
0 0 0 0 0 0 0 0 0 0 0
0 0 0 0 0 0 0 0 0 0 0
0 0 0 3 0 0 6 0 0 0 0
0 0 0 0 0 0 0 0 0 0 0
0 0 0 0 0 0 0 0 0 0 0
0 0 0 0 0 0 0 0 0 0 0
0 0 0 0 0 0 0 0 0 0 0
0 0 0 0 8 0 0 0 0 0 0
0 0 0 0 0 0 0 0 0 0 0
0 0 0 0 0 0 0 0 0 0 0
0 0 0 0 0 0 0 6 2 0 0
0 0 0 0 0 0 0 0 0 0 0
0 4 0 0 0 0 4 0 0 0 0
0 0 0 0 0 0 0 0 0 0 0
0 0 0 0 3 0 0 0 0 0 0
0 0 0 0 0 0 0 0 0 0 0
0 0 0 0 0 0 0 0 0 0 0
