11
17
1
1
0
0
0
0
13
2
5
30
15
10 10 10 10 10 10 10 10 10 10 10
10 10 10 10 6 10 6 10 10 10 10
10 10 4 10 9 10 9 10 4 10 10
10 10 9 10 10 10 10 10 9 10 10
10 10 10 10 4 10 10 10 10 10 10
10 5 10 4 4 4 10 10 10 5 10
10 9 10 4 4 4 6 10 10 9 10
10 10 10 4 4 4 6 6 10 10 10
10 10 10 10 4 6 6 6 10 10 10
10 5 10 5 5 5 6 10 10 5 10
10 9 10 5 5 5 10 10 10 9 10
10 10 10 10 5 10 10 10 10 10 10
10 10 4 10 10 10 10 10 4 10 10
10 10 9 10 6 10 6 10 9 10 10
10 10 10 10 9 10 9 10 10 10 10
10 10 10 10 10 10 10 10 10 10 10
10 10 10 10 10 10 10 10 10 10 10
0 0 0 0 0 0 0 0 0 0 0
0 0 0 0 0 0 0 0 0 0 0
0 0 0 0 0 0 0 0 1 0 0
0 0 0 0 0 0 0 0 0 0 0
0 0 0 0 0 0 0 0 0 0 0
0 2 0 0 0 0 0 0 0 0 0
0 0 0 0 0 0 0 0 0 0 0
0 0 0 0 0 0 0 0 0 0 0
0 0 0 0 0 0 1 0 0 0 0
0 0 0 2 0 0 0 0 0 0 0
0 0 0 0 0 0 0 0 0 0 0
0 0 0 0 0 0 0 0 0 0 0
0 0 0 0 0 0 0 0 1 0 0
0 0 0 0 2 0 0 0 0 0 0
0 0 0 0 0 0 0 0 0 0 0
0 0 0 0 0 0 0 0 0 0 0
0 0 0 0 0 0 0 0 0 0 0
0 0 0 0 0 0 0 0 0 0 0
0 0 0 0 0 0 0 0 0 0 0
0 0 0 0 0 0 0 0 8 0 0
0 0 0 0 0 0 0 0 0 0 0
0 0 0 0 0 0 0 0 0 0 0
0 12 0 0 0 0 0 0 0 0 0
0 0 0 0 0 0 0 0 0 0 0
0 0 0 0 0 0 0 0 0 0 0
0 0 0 0 0 0 4 0 0 0 0
0 0 0 6 0 0 0 0 0 0 0
0 0 0 0 0 0 0 0 0 0 0
0 0 0 0 0 0 0 0 0 0 0
0 0 0 0 0 0 0 0 3 0 0
0 0 0 0 2 0 0 0 0 0 0
0 0 0 0 0 0 0 0 0 0 0
0 0 0 0 0 0 0 0 0 0 0
0 0 0 0 0 0 0 0 0 0 0
