11
17
1
1
0
0
0
0
3
1
5
30
15
10 10 10 10 10 10 10 10 10 10 10
10 10 10 11 10 10 10 11 10 10 10
10 10 11 2 11 10 11 4 11 10 10
10 11 2 2 2 11 4 4 4 11 10
10 11 2 2 2 11 4 4 4 11 10
11 2 2 2 2 4 4 4 4 4 11
11 2 2 2 2 2 4 4 4 4 11
8 2 2 2 2 4 4 4 4 4 8
10 8 2 2 2 2 4 4 4 8 10
10 8 2 2 2 4 4 4 4 8 10
10 10 8 2 2 2 4 4 8 10 10
10 10 10 8 2 4 4 8 10 10 10
10 10 10 10 8 2 8 10 10 10 10
10 10 10 10 10 8 10 10 10 10 10
10 10 10 10 10 10 10 10 10 10 10
10 10 10 10 10 10 10 10 10 10 10
10 10 10 10 10 10 10 10 10 10 10
0 0 0 0 0 0 0 0 0 0 0
0 0 0 0 0 0 0 0 0 0 0
0 0 0 0 0 0 0 0 0 0 0
0 0 0 0 0 0 0 0 1 0 0
0 0 0 1 0 0 0 0 0 0 0
0 0 0 0 0 0 0 0 0 0 0
0 0 3 0 0 0 1 0 0 0 0
0 0 0 0 0 0 0 0 0 0 0
0 0 0 0 0 0 0 0 1 0 0
0 0 1 0 2 0 0 0 0 0 0
0 0 0 0 0 0 0 0 0 0 0
0 0 0 0 0 0 2 0 0 0 0
0 0 0 0 0 0 0 0 0 0 0
0 0 0 0 0 1 0 0 0 0 0
0 0 0 0 0 0 0 0 0 0 0
0 0 0 0 0 0 0 0 0 0 0
0 0 0 0 0 0 0 0 0 0 0
0 0 0 0 0 0 0 0 0 0 0
0 0 0 0 0 0 0 0 0 0 0
0 0 0 0 0 0 0 0 0 0 0
0 0 0 0 0 0 0 0 12 0 0
0 0 0 10 0 0 0 0 0 0 0
0 0 0 0 0 0 0 0 0 0 0
0 0 6 0 0 0 2 0 0 0 0
0 0 0 0 0 0 0 0 0 0 0
0 0 0 0 0 0 0 0 2 0 0
0 0 3 0 1 0 0 0 0 0 0
0 0 0 0 0 0 0 0 0 0 0
0 0 0 0 0 0 3 0 0 0 0
0 0 0 0 0 0 0 0 0 0 0
0 0 0 0 0 9 0 0 0 0 0
0 0 0 0 0 0 0 0 0 0 0
0 0 0 0 0 0 0 0 0 0 0
0 0 0 0 0 0 0 0 0 0 0
