11
17
0
0
1
0
1
0
8
0
5
30
15
10 11 10 11 10 11 10 11 10 11 10
10 4 10 1 10 3 10 4 10 1 10
10 11 10 11 10 11 10 11 10 11 10
10 3 10 4 10 1 10 3 10 4 10
10 11 10 11 10 11 10 11 10 11 10
10 1 10 3 10 4 10 1 10 3 10
10 11 10 11 10 11 10 11 10 11 10
10 4 10 1 10 3 10 4 10 1 10
10 11 10 11 10 11 10 11 10 11 10
10 3 10 4 10 1 10 3 10 4 10
10 11 10 11 10 11 10 11 10 11 10
10 1 10 3 10 4 10 1 10 3 10
10 11 10 11 10 11 10 11 10 11 10
10 4 10 1 10 3 10 4 10 1 10
10 11 10 11 10 11 10 11 10 11 10
10 3 10 4 10 1 10 3 10 4 10
10 11 10 11 10 11 10 11 10 11 10
0 0 0 0 0 0 0 0 0 0 0
0 0 0 1 0 0 0 0 0 0 0
0 0 0 0 0 0 0 0 0 0 0
0 0 0 0 0 0 0 0 0 0 0
0 0 0 0 0 0 0 0 0 0 0
0 0 0 2 0 0 0 2 0 0 0
0 0 0 0 0 0 0 0 0 0 0
0 0 0 0 0 0 0 0 0 0 0
0 0 0 0 0 0 0 0 0 0 0
0 0 0 0 0 1 0 0 0 2 0
0 0 0 0 0 0 0 0 0 0 0
0 1 0 0 0 0 0 0 0 0 0
0 0 0 0 0 0 0 0 0 0 0
0 0 0 0 0 0 0 0 0 0 0
0 0 0 0 0 0 0 0 0 0 0
0 0 0 2 0 0 0 0 0 0 0
0 0 0 0 0 0 0 0 0 0 0
0 0 0 0 0 0 0 0 0 0 0
0 0 0 3 0 0 0 0 0 0 0
0 0 0 0 0 0 0 0 0 0 0
0 0 0 0 0 0 0 0 0 0 0
0 0 0 0 0 0 0 0 0 0 0
0 0 0 3 0 0 0 5 0 0 0
0 0 0 0 0 0 0 0 0 0 0
0 0 0 0 0 0 0 0 0 0 0
0 0 0 0 0 0 0 0 0 0 0
0 0 0 0 0 4 0 0 0 8 0
0 0 0 0 0 0 0 0 0 0 0
0 9 0 0 0 0 0 0 0 0 0
0 0 0 0 0 0 0 0 0 0 0
0 0 0 0 0 0 0 0 0 0 0
0 0 0 0 0 0 0 0 0 0 0
0 0 0 10 0 0 0 0 0 0 0
0 0 0 0 0 0 0 0 0 0 0
