11
17
0
0
1
1
1
1
5
3
5
30
15
10 9 10 9 6 6 6 9 10 9 10
10 9 10 9 6 6 6 9 10 9 10
10 9 10 9 6 6 6 9 10 9 10
10 9 10 9 5 5 5 9 10 9 10
10 9 10 9 5 5 5 9 10 9 10
10 9 10 9 5 5 5 9 10 9 10
10 9 10 9 4 4 4 9 10 9 10
10 9 10 9 4 4 4 9 10 9 10
10 9 10 9 4 4 4 9 10 9 10
10 9 10 9 3 3 3 9 10 9 10
10 9 10 9 3 3 3 9 10 9 10
10 9 10 9 3 3 3 9 10 9 10
10 9 10 9 4 4 4 9 10 9 10
10 9 10 9 4 4 4 9 10 9 10
10 9 10 9 4 4 4 9 10 9 10
10 9 8 9 10 10 10 9 8 9 10
10 10 10 10 10 10 10 10 10 10 10
0 0 0 0 0 0 0 0 0 0 0
0 0 0 0 0 0 0 0 0 0 0
0 0 0 0 0 0 1 0 0 0 0
0 0 0 0 0 0 0 0 0 0 0
0 0 0 0 0 0 0 0 0 0 0
0 0 0 0 1 0 2 0 0 0 0
0 0 0 0 0 0 0 0 0 0 0
0 0 0 0 0 0 0 0 0 0 0
0 0 0 0 2 0 0 0 0 0 0
0 0 0 0 0 0 0 0 0 0 0
0 0 0 0 1 0 0 0 0 0 0
0 0 0 0 0 1 0 0 0 0 0
0 0 0 0 0 0 0 0 0 0 0
0 0 0 0 4 0 2 0 0 0 0
0 0 0 0 0 1 0 0 0 0 0
0 0 0 0 0 0 0 0 0 0 0
0 0 0 0 0 0 0 0 0 0 0
0 0 0 0 0 0 0 0 0 0 0
0 0 0 0 0 0 0 0 0 0 0
0 0 0 0 0 0 0 0 0 0 0
0 0 0 0 0 0 0 0 0 0 0
0 0 0 0 0 0 0 0 0 0 0
0 0 0 0 9 0 4 0 0 0 0
0 0 0 0 0 0 0 0 0 0 0
0 0 0 0 0 0 0 0 0 0 0
0 0 0 0 3 0 0 0 0 0 0
0 0 0 0 0 0 0 0 0 0 0
0 0 0 0 9 0 0 0 0 0 0
0 0 0 0 0 4 0 0 0 0 0
0 0 0 0 0 0 0 0 0 0 0
0 0 0 0 8 0 3 0 0 0 0
0 0 0 0 0 2 0 0 0 0 0
0 0 0 0 0 0 0 0 0 0 0
0 0 0 0 0 0 0 0 0 0 0
