11
17
1
1
1
1
1
1
8
4
5
7
3
10 10 10 10 3 9 3 10 10 10 10
10 10 10 10 3 9 3 10 10 10 10
10 10 10 10 3 9 3 10 10 10 10
10 10 10 10 3 9 3 10 10 10 10
10 10 10 10 6 9 6 10 10 10 10
10 10 10 10 6 9 6 10 10 10 10
10 10 10 10 2 9 2 10 10 10 10
10 10 10 10 2 9 2 10 10 10 10
10 10 10 10 0 9 0 10 10 10 10
10 10 10 10 0 9 0 10 10 10 10
10 10 10 10 3 9 3 10 10 10 10
10 10 10 10 3 9 3 10 10 10 10
10 10 10 10 3 9 3 10 10 10 10
10 10 10 10 3 9 3 10 10 10 10
10 10 10 10 6 9 6 10 10 10 10
10 10 10 10 6 9 6 10 10 10 10
10 10 10 10 10 10 10 10 10 10 10
0 0 0 0 1 0 1 0 0 0 0
0 0 0 0 0 0 0 0 0 0 0
0 0 0 0 0 0 0 0 0 0 0
0 0 0 0 1 0 2 0 0 0 0
0 0 0 0 0 0 0 0 0 0 0
0 0 0 0 0 0 0 0 0 0 0
0 0 0 0 0 0 0 0 0 0 0
0 0 0 0 0 0 0 0 0 0 0
0 0 0 0 1 0 1 0 0 0 0
0 0 0 0 0 0 0 0 0 0 0
0 0 0 0 0 0 0 0 0 0 0
0 0 0 0 0 0 0 0 0 0 0
0 0 0 0 0 0 0 0 0 0 0
0 0 0 0 2 0 1 0 0 0 0
0 0 0 0 0 0 0 0 0 0 0
0 0 0 0 0 0 0 0 0 0 0
0 0 0 0 0 0 0 0 0 0 0
0 0 0 0 13 0 10 0 0 0 0
0 0 0 0 0 0 0 0 0 0 0
0 0 0 0 0 0 0 0 0 0 0
0 0 0 0 1 0 2 0 0 0 0
0 0 0 0 0 0 0 0 0 0 0
0 0 0 0 0 0 0 0 0 0 0
0 0 0 0 0 0 0 0 0 0 0
0 0 0 0 0 0 0 0 0 0 0
0 0 0 0 3 0 2 0 0 0 0
0 0 0 0 0 0 0 0 0 0 0
0 0 0 0 0 0 0 0 0 0 0
0 0 0 0 0 0 0 0 0 0 0
0 0 0 0 0 0 0 0 0 0 0
0 0 0 0 3 0 2 0 0 0 0
0 0 0 0 0 0 0 0 0 0 0
0 0 0 0 0 0 0 0 0 0 0
0 0 0 0 0 0 0 0 0 0 0
