11
17
1
1
1
1
1
1
5
0
5
30
15
10 10 10 10 10 10 10 10 10 10 10
10 10 10 10 10 10 10 10 10 10 10
10 10 10 10 10 10 10 10 10 10 10
3 4 6 4 10 9 10 4 6 4 3
3 4 6 4 10 9 10 4 6 4 3
3 4 6 4 10 9 10 4 6 4 3
3 4 6 4 10 9 10 4 6 4 3
3 4 6 4 10 9 10 4 6 4 3
3 4 6 4 10 9 10 4 6 4 3
9 9 9 9 10 0 10 9 9 9 9
0 0 0 0 10 9 10 0 0 0 0
3 4 6 4 10 9 10 4 6 4 3
3 4 6 4 10 9 10 4 6 4 3
3 4 6 4 10 9 10 4 6 4 3
3 4 6 4 10 9 10 4 6 4 3
8 9 9 9 8 9 8 9 9 9 8
10 10 10 10 10 10 10 10 10 10 10
0 0 0 0 0 0 0 0 0 0 0
0 0 0 0 0 0 0 0 0 0 0
0 0 0 0 0 0 0 0 0 0 0
0 0 0 0 0 0 0 1 0 0 0
0 2 0 0 0 0 0 0 0 0 0
0 0 0 0 0 0 0 0 0 0 2
0 0 0 0 0 0 0 0 0 0 0
0 0 0 0 0 0 0 0 0 0 0
0 0 0 0 0 0 0 0 0 0 0
0 0 0 0 0 0 0 0 0 0 0
0 0 0 0 0 0 0 0 0 0 0
0 0 0 0 0 0 0 0 0 0 0
0 1 0 0 0 0 0 0 0 0 2
1 0 0 0 0 0 0 0 0 0 0
0 0 0 0 0 0 0 1 0 0 1
0 0 0 0 0 0 0 0 0 0 0
0 0 0 0 0 0 0 0 0 0 0
0 0 0 0 0 0 0 0 0 0 0
0 0 0 0 0 0 0 0 0 0 0
0 0 0 0 0 0 0 0 0 0 0
0 0 0 0 0 0 0 3 0 0 0
0 8 0 0 0 0 0 0 0 0 0
0 0 0 0 0 0 0 0 0 0 8
0 0 0 0 0 0 0 0 0 0 0
0 0 0 0 0 0 0 0 0 0 0
0 0 0 0 0 0 0 0 0 0 0
0 0 0 0 0 0 0 0 0 0 0
0 0 0 0 0 0 0 0 0 0 0
0 0 0 0 0 0 0 0 0 0 0
0 1 0 0 0 0 0 0 0 0 3
2 0 0 0 0 0 0 0 0 0 0
0 0 0 0 0 0 0 4 0 0 3
0 0 0 0 0 0 0 0 0 0 0
0 0 0 0 0 0 0 0 0 0 0
