11
17
1
1
1
1
1
1
1
5
5
30
15
10 10 10 10 10 10 10 10 10 10 10
10 10 10 10 10 10 10 10 10 10 10
10 10 10 10 10 9 10 10 10 10 10
10 10 10 10 10 5 10 10 10 10 10
10 10 10 9 10 9 10 9 10 10 10
10 10 10 5 10 5 10 5 10 10 10
10 10 10 9 8 9 8 9 10 10 10
10 10 10 5 10 5 10 5 10 10 10
10 10 10 9 5 9 5 9 10 10 10
10 9 9 9 9 9 9 9 9 9 10
10 10 8 10 10 10 10 10 8 10 10
10 10 5 5 5 5 5 5 5 10 10
10 10 9 9 9 9 9 9 9 10 10
10 10 10 8 10 10 10 8 10 10 10
10 10 10 5 5 5 5 5 10 10 10
10 10 10 9 9 9 9 9 10 10 10
10 10 10 10 10 10 10 10 10 10 10
0 0 0 0 0 0 0 0 0 0 0
0 0 0 0 0 0 0 0 0 0 0
0 0 0 0 0 0 0 0 0 0 0
0 0 0 0 0 1 0 0 0 0 0
0 0 0 0 0 0 0 0 0 0 0
0 0 0 0 0 0 0 0 0 0 0
0 0 0 0 0 0 0 0 0 0 0
0 0 0 0 0 0 0 0 0 0 0
0 0 0 0 1 0 0 0 0 0 0
0 0 0 0 0 0 0 0 0 0 0
0 0 0 0 0 0 0 0 0 0 0
0 0 0 0 0 0 0 0 2 0 0
0 0 0 0 0 0 0 0 0 0 0
0 0 0 1 0 0 0 2 0 0 0
0 0 0 0 0 1 0 0 0 0 0
0 0 0 0 0 0 0 0 0 0 0
0 0 0 0 0 0 0 0 0 0 0
0 0 0 0 0 0 0 0 0 0 0
0 0 0 0 0 0 0 0 0 0 0
0 0 0 0 0 0 0 0 0 0 0
0 0 0 0 0 6 0 0 0 0 0
0 0 0 0 0 0 0 0 0 0 0
0 0 0 0 0 0 0 0 0 0 0
0 0 0 0 0 0 0 0 0 0 0
0 0 0 0 0 0 0 0 0 0 0
0 0 0 0 13 0 0 0 0 0 0
0 0 0 0 0 0 0 0 0 0 0
0 0 0 0 0 0 0 0 0 0 0
0 0 0 0 0 0 0 0 13 0 0
0 0 0 0 0 0 0 0 0 0 0
0 0 0 13 0 0 0 3 0 0 0
0 0 0 0 0 6 0 0 0 0 0
0 0 0 0 0 0 0 0 0 0 0
0 0 0 0 0 0 0 0 0 0 0
