11
17
1
1
0
0
0
0
3
0
5
30
15
10 10 10 10 10 10 10 10 10 10 10
10 10 10 10 10 10 10 10 10 10 10
10 8 7 5 2 10 7 5 3 8 10
10 3 5 7 4 10 5 7 8 3 10
10 5 2 4 7 10 3 8 7 5 10
10 7 4 2 5 10 8 3 5 7 10
10 4 7 5 3 10 7 5 2 4 10
10 2 5 7 8 10 5 7 4 2 10
10 5 3 8 7 10 2 4 7 5 10
10 7 8 3 5 10 4 2 5 7 10
10 8 7 5 2 10 7 5 3 8 10
10 0 5 7 4 10 5 7 8 3 10
10 5 2 4 7 10 3 8 7 5 10
10 7 4 2 5 10 8 3 5 7 10
10 4 7 5 3 10 7 5 2 4 10
10 2 5 7 8 10 5 7 4 2 10
10 10 10 10 10 10 10 10 10 10 10
0 0 0 0 0 0 0 0 0 0 0
0 0 0 0 0 0 0 0 0 0 0
0 0 0 0 0 0 1 0 0 2 0
0 0 0 0 0 0 0 0 0 0 0
0 0 0 0 0 0 0 2 0 0 0
0 2 0 0 1 0 0 0 0 0 0
0 0 0 0 0 0 0 0 0 2 0
0 0 0 0 0 0 0 0 0 1 0
0 0 0 0 0 0 0 0 0 0 0
0 0 0 0 0 0 0 0 0 0 0
0 1 0 2 0 0 0 0 0 1 0
0 0 0 0 0 0 0 0 0 0 0
0 0 0 1 0 0 0 0 0 0 0
0 0 0 0 0 0 0 4 0 0 0
0 0 2 0 0 0 0 1 0 0 0
0 0 0 0 0 0 0 0 0 0 0
0 0 0 0 0 0 0 0 0 0 0
0 0 0 0 0 0 0 0 0 0 0
0 0 0 0 0 0 0 0 0 0 0
0 0 9 0 0 0 7 0 0 9 0
0 0 0 0 0 0 0 0 0 0 0
0 0 0 0 0 0 0 0 0 0 0
0 8 0 0 4 0 0 0 0 0 0
0 0 0 0 0 0 0 0 0 8 0
0 0 0 0 0 0 0 0 0 2 0
0 3 0 0 0 0 0 3 0 0 0
0 0 0 0 0 0 0 0 0 0 0
0 1 0 2 0 0 0 0 0 7 0
0 0 0 0 0 0 0 0 0 0 0
0 0 0 1 0 0 0 0 0 0 0
0 0 0 0 0 0 0 0 0 0 0
0 0 1 0 0 0 0 2 0 0 0
0 0 0 0 0 0 0 0 0 0 0
0 0 0 0 0 0 0 0 0 0 0
