11
17
1
1
1
0
1
0
9
0
5
30
15
10 10 10 10 10 10 10 10 10 10 10
10 10 10 10 10 10 10 10 10 10 10
10 10 10 7 10 10 10 7 10 10 10
10 10 10 10 7 10 7 10 10 10 10
10 10 10 10 7 10 7 10 10 10 10
10 10 10 8 8 8 8 8 10 10 10
10 10 10 8 8 8 8 8 10 10 10
10 10 8 8 4 8 4 8 8 10 10
10 10 8 8 4 8 4 8 8 10 10
10 8 8 8 8 8 8 8 8 8 10
10 8 8 8 8 8 8 8 8 8 10
10 8 10 8 8 8 8 8 10 8 10
10 8 10 8 10 10 10 8 10 8 10
10 8 10 8 10 10 10 8 10 8 10
10 10 10 10 8 10 8 10 10 10 10
10 10 10 10 8 10 8 10 10 10 10
10 10 10 10 10 10 10 10 10 10 10
0 0 0 0 0 0 0 0 0 0 0
0 0 0 0 0 0 0 0 0 0 0
0 0 0 0 0 0 0 0 0 0 0
0 0 0 0 0 0 2 0 0 0 0
0 0 0 0 0 0 1 0 0 0 0
0 0 0 0 0 0 0 0 0 0 0
0 0 0 0 0 1 0 1 0 0 0
0 0 0 0 0 0 0 0 0 0 0
0 0 2 0 0 0 1 1 0 0 0
0 0 0 0 0 0 0 0 2 0 0
0 0 0 1 0 0 0 0 0 0 0
0 0 0 0 0 0 0 0 0 2 0
0 0 0 1 0 0 0 0 0 0 0
0 0 0 0 0 0 0 0 0 0 0
0 0 0 0 1 0 0 0 0 0 0
0 0 0 0 0 0 0 0 0 0 0
0 0 0 0 0 0 0 0 0 0 0
0 0 0 0 0 0 0 0 0 0 0
0 0 0 0 0 0 0 0 0 0 0
0 0 0 0 0 0 0 0 0 0 0
0 0 0 0 0 0 0 0 0 0 0
0 0 0 0 0 0 1 0 0 0 0
0 0 0 7 2 0 0 0 0 0 0
0 0 0 0 0 0 0 2 0 0 0
0 0 0 0 0 0 0 0 0 0 0
0 0 2 0 0 0 6 9 0 0 0
0 0 0 0 0 0 0 0 1 0 0
0 0 0 0 0 0 4 0 0 0 0
0 0 0 0 0 0 0 0 0 3 0
0 0 0 2 0 0 0 0 0 0 0
0 0 0 0 0 0 0 0 0 0 0
0 0 0 0 3 0 0 0 0 0 0
0 0 0 0 0 0 0 0 0 0 0
0 0 0 0 0 0 0 0 0 0 0
