11
17
1
1
0
1
0
1
1
3
5
30
15
10 10 10 10 10 10 10 10 10 10 10
10 10 10 10 10 10 10 10 10 10 10
10 9 10 9 10 10 10 9 10 9 10
10 9 5 9 10 10 10 9 5 9 10
10 9 3 9 10 10 10 9 3 9 10
10 9 9 9 10 10 10 9 9 9 10
10 10 10 10 10 10 10 10 10 10 10
10 10 10 2 6 3 3 7 10 10 10
10 10 10 2 5 6 5 7 10 10 10
10 10 10 2 6 5 6 7 10 10 10
10 10 10 2 5 6 5 7 10 10 10
10 10 10 2 6 5 6 7 10 10 10
10 10 10 2 3 3 3 7 10 10 10
10 10 10 10 10 10 10 10 10 10 10
10 10 10 10 10 10 10 10 10 10 10
10 10 10 10 10 10 10 10 10 10 10
10 10 10 10 10 10 10 10 10 10 10
0 0 0 0 0 0 0 0 0 0 0
0 0 0 0 0 0 0 0 0 0 0
0 0 0 0 0 0 0 0 0 0 0
0 0 2 0 0 0 0 0 0 0 0
0 0 0 0 0 0 0 0 2 0 0
0 0 0 0 0 0 0 0 0 0 0
0 0 0 0 0 0 0 0 0 0 0
0 0 0 0 1 0 0 0 0 0 0
0 0 0 1 2 0 0 0 0 0 0
0 0 0 0 0 0 0 3 0 0 0
0 0 0 2 0 0 1 0 0 0 0
0 0 0 0 0 0 0 0 0 0 0
0 0 0 0 0 2 0 0 0 0 0
0 0 0 0 0 0 0 0 0 0 0
0 0 0 0 0 0 0 0 0 0 0
0 0 0 0 0 0 0 0 0 0 0
0 0 0 0 0 0 0 0 0 0 0
0 0 0 0 0 0 0 0 0 0 0
0 0 0 0 0 0 0 0 0 0 0
0 0 0 0 0 0 0 0 0 0 0
0 0 3 0 0 0 0 0 0 0 0
0 0 0 0 0 0 0 0 2 0 0
0 0 0 0 0 0 0 0 0 0 0
0 0 0 0 0 0 0 0 0 0 0
0 0 0 0 3 0 0 0 0 0 0
0 0 0 0 9 0 0 0 0 0 0
0 0 0 0 0 0 0 8 0 0 0
0 0 0 8 1 0 7 0 0 0 0
0 0 0 0 0 0 0 0 0 0 0
0 0 0 0 0 4 0 0 0 0 0
0 0 0 0 0 0 0 0 0 0 0
0 0 0 0 0 0 0 0 0 0 0
0 0 0 0 0 0 0 0 0 0 0
0 0 0 0 0 0 0 0 0 0 0
