11
17
1
1
0
0
0
0
7
3
5
30
15
10 10 10 10 10 10 10 10 10 10 10
10 10 10 10 10 10 10 10 10 10 10
4 8 8 8 8 8 8 8 8 8 4
9 10 10 10 10 10 10 10 10 10 9
3 3 3 3 3 3 3 3 3 3 3
10 10 10 10 10 10 10 10 10 10 10
2 8 8 8 8 8 8 8 8 8 2
9 10 10 10 10 10 10 10 10 10 9
3 3 3 3 3 3 3 3 3 3 3
10 10 10 10 10 10 10 10 10 10 10
3 8 8 8 8 8 8 8 8 8 3
9 10 10 10 10 10 10 10 10 10 9
4 4 4 4 4 4 4 4 4 4 4
10 10 10 10 10 10 10 10 10 10 10
4 4 4 4 4 4 4 4 4 4 4
9 10 10 10 10 10 10 10 10 10 9
10 10 10 10 10 10 10 10 10 10 10
0 0 0 0 0 0 0 0 0 0 0
0 0 0 0 0 0 0 0 0 0 0
0 0 0 2 0 1 0 0 3 0 0
0 0 0 0 0 0 0 0 0 0 0
0 0 0 0 0 0 1 0 0 0 0
0 0 0 0 0 0 0 0 0 0 0
0 0 0 0 2 0 0 0 0 0 0
0 0 0 0 0 0 0 0 0 0 0
0 0 0 0 0 0 0 0 0 0 0
0 0 0 0 1 0 0 0 0 0 0
0 0 0 0 3 0 0 0 0 0 0
0 0 0 0 0 0 0 0 0 0 0
0 2 0 0 0 3 0 0 0 0 0
0 0 0 0 0 0 0 0 0 0 0
0 2 0 0 0 0 0 1 0 0 0
0 0 0 0 0 0 0 0 0 0 0
0 0 0 0 0 0 0 0 0 0 0
0 0 0 0 0 0 0 0 0 0 0
0 0 0 0 0 0 0 0 0 0 0
0 0 0 8 0 0 0 0 8 0 0
0 0 0 0 0 0 0 0 0 0 0
0 0 0 0 0 0 7 0 0 0 0
0 0 0 0 0 0 0 0 0 0 0
0 0 0 0 3 0 0 0 0 0 0
0 0 0 0 0 0 0 0 0 0 0
0 0 0 0 0 0 0 0 6 0 0
0 0 0 0 0 0 0 0 0 0 0
0 0 0 0 0 0 0 5 0 0 0
0 0 0 0 0 0 0 0 0 0 0
0 1 0 0 0 3 0 0 4 0 0
0 0 0 0 0 0 0 0 0 0 0
0 0 0 0 0 0 0 2 0 0 0
0 0 0 0 0 0 0 0 0 0 0
0 0 0 0 0 0 0 0 0 0 0
