11
17
1
1
0
0
0
0
3
2
5
30
15
10 10 10 10 10 10 10 10 10 10 10
10 10 10 10 10 10 10 10 10 10 10
10 10 10 10 10 9 10 10 10 10 10
10 10 10 0 0 10 0 0 10 10 10
10 0 0 10 10 9 10 10 0 0 10
0 10 10 7 7 10 7 7 10 10 0
10 7 7 10 10 9 10 10 7 7 10
7 10 10 5 5 10 5 5 10 10 7
10 5 5 10 10 9 10 10 5 5 10
5 10 10 4 4 10 4 4 10 10 5
10 4 4 10 10 9 10 10 4 4 10
4 10 10 3 3 10 3 3 10 10 4
10 3 3 10 10 9 10 10 3 3 10
3 10 10 5 5 10 5 5 10 10 3
10 5 5 10 10 10 10 10 5 5 10
5 10 10 10 10 10 10 10 10 10 5
10 10 10 10 10 10 10 10 10 10 10
0 0 0 0 0 0 0 0 0 0 0
0 0 0 0 0 0 0 0 0 0 0
0 0 0 0 0 0 0 0 0 0 0
0 0 0 0 0 0 0 0 0 0 0
0 1 0 0 0 0 0 0 0 2 0
2 0 0 0 0 0 0 1 0 0 0
0 0 1 0 0 0 0 0 0 0 0
0 0 0 0 0 0 0 1 0 0 0
0 0 0 0 0 0 0 0 0 1 0
0 0 0 0 0 0 2 0 0 0 0
0 0 2 0 0 0 0 0 0 0 0
0 0 0 0 0 0 0 0 0 0 0
0 3 0 0 0 0 0 0 0 0 0
0 0 0 0 0 0 2 0 0 0 0
0 0 1 0 0 0 0 0 0 2 0
0 0 0 0 0 0 0 0 0 0 0
0 0 0 0 0 0 0 0 0 0 0
0 0 0 0 0 0 0 0 0 0 0
0 0 0 0 0 0 0 0 0 0 0
0 0 0 0 0 0 0 0 0 0 0
0 0 0 0 0 0 0 0 0 0 0
0 7 0 0 0 0 0 0 0 3 0
8 0 0 0 0 0 0 1 0 0 0
0 0 4 0 0 0 0 0 0 0 0
0 0 0 0 0 0 0 0 0 0 0
0 0 0 0 0 0 0 0 0 9 0
0 0 0 0 0 0 3 0 0 0 0
0 0 2 0 0 0 0 0 0 0 0
0 0 0 0 0 0 0 0 0 0 0
0 6 0 0 0 0 0 0 0 0 0
0 0 0 0 0 0 2 0 0 0 0
0 0 0 0 0 0 0 0 0 4 0
0 0 0 0 0 0 0 0 0 0 0
0 0 0 0 0 0 0 0 0 0 0
