11
17
1
1
1
1
1
1
10
0
5
30
15
10 10 10 10 10 10 10 10 10 10 10
10 10 10 10 10 10 10 10 10 10 10
10 10 10 10 10 8 10 10 10 10 10
10 10 10 3 3 8 5 5 10 10 10
10 10 3 3 0 0 0 5 5 10 10
10 3 3 0 0 0 0 0 5 5 10
10 3 3 0 0 0 0 0 5 5 10
10 3 3 0 0 0 0 0 5 5 10
10 8 10 8 10 8 10 8 10 8 10
10 10 10 10 10 8 10 10 10 10 10
10 10 10 10 10 8 10 10 10 10 10
10 10 10 9 10 9 10 10 10 10 10
10 10 10 9 9 9 10 10 10 10 10
10 10 10 10 9 10 10 10 10 10 10
10 10 10 10 10 10 10 10 10 10 10
10 10 10 10 10 10 10 10 10 10 10
10 10 10 10 10 10 10 10 10 10 10
0 0 0 0 0 0 0 0 0 0 0
0 0 0 0 0 0 0 0 0 0 0
0 0 0 0 0 0 0 0 0 0 0
0 0 0 0 0 0 0 0 0 0 0
0 0 0 1 0 0 0 0 1 0 0
0 0 0 0 0 0 2 0 0 0 0
0 2 2 0 1 0 0 0 0 2 0
0 1 0 0 0 0 2 0 2 0 0
0 0 0 0 0 0 0 0 0 0 0
0 0 0 0 0 0 0 0 0 0 0
0 0 0 0 0 0 0 0 0 0 0
0 0 0 0 0 0 0 0 0 0 0
0 0 0 0 0 0 0 0 0 0 0
0 0 0 0 0 0 0 0 0 0 0
0 0 0 0 0 0 0 0 0 0 0
0 0 0 0 0 0 0 0 0 0 0
0 0 0 0 0 0 0 0 0 0 0
0 0 0 0 0 0 0 0 0 0 0
0 0 0 0 0 0 0 0 0 0 0
0 0 0 0 0 0 0 0 0 0 0
0 0 0 0 0 0 0 9 0 0 0
0 0 0 4 0 0 0 0 2 0 0
0 2 0 0 0 0 1 0 0 0 0
0 0 3 0 2 0 0 0 0 8 0
0 2 0 0 0 0 4 0 5 0 0
0 0 0 0 0 0 0 0 0 0 0
0 0 0 0 0 0 0 0 0 0 0
0 0 0 0 0 0 0 0 0 0 0
0 0 0 0 0 0 0 0 0 0 0
0 0 0 0 0 0 0 0 0 0 0
0 0 0 0 0 0 0 0 0 0 0
0 0 0 0 0 0 0 0 0 0 0
0 0 0 0 0 0 0 0 0 0 0
0 0 0 0 0 0 0 0 0 0 0
