11
17
1
1
1
0
1
0
11
0
7
30
15
10 10 10 10 10 10 10 10 10 10 10
10 10 10 10 10 10 10 10 10 10 10
10 10 10 10 10 10 10 10 10 10 10
10 10 10 10 10 10 10 10 10 10 10
10 10 10 10 10 10 10 10 10 10 10
10 10 10 10 10 10 10 10 10 10 10
10 10 10 10 10 10 10 10 10 10 10
10 10 10 10 0 0 0 10 10 10 10
10 10 10 10 0 0 0 10 10 10 10
10 10 10 10 0 0 0 10 10 10 10
10 10 10 0 3 0 3 0 10 10 10
10 10 10 3 3 3 3 3 10 10 10
10 10 3 3 3 3 3 3 3 10 10
10 10 3 3 3 3 3 3 3 10 10
10 3 3 3 3 3 3 3 3 3 10
3 3 3 3 3 3 3 3 3 3 3
10 10 10 10 10 10 10 10 10 10 10
0 0 0 0 0 0 0 0 0 0 0
0 0 0 0 0 0 0 0 0 0 0
0 0 0 0 0 0 0 0 0 0 0
0 0 0 0 0 0 0 0 0 0 0
0 0 0 0 0 0 0 0 0 0 0
0 0 0 0 0 0 0 0 0 0 0
0 0 0 0 0 0 0 0 0 0 0
0 0 0 0 0 0 0 0 0 0 0
0 0 0 0 0 0 0 0 0 0 0
0 0 0 0 3 0 3 0 0 0 0
0 0 0 0 0 0 0 0 0 0 0
0 0 0 0 1 0 0 0 0 0 0
0 0 0 0 0 0 0 0 1 0 0
0 0 1 0 3 0 0 0 0 0 0
0 0 0 1 0 0 0 2 0 0 0
0 4 2 0 0 2 0 0 2 0 0
0 0 0 0 0 0 0 0 0 0 0
0 0 0 0 0 0 0 0 0 0 0
0 0 0 0 0 0 0 0 0 0 0
0 0 0 0 0 0 0 0 0 0 0
0 0 0 0 0 0 0 0 0 0 0
0 0 0 0 0 0 0 0 0 0 0
0 0 0 0 0 0 0 0 0 0 0
0 0 0 0 0 0 0 0 0 0 0
0 0 0 0 0 0 0 0 0 0 0
0 0 0 0 0 0 0 0 0 0 0
0 0 0 0 6 0 5 0 0 0 0
0 0 0 0 0 0 0 0 0 0 0
0 0 0 0 4 0 0 0 0 0 0
0 0 7 0 0 0 1 0 9 0 0
0 0 0 0 2 0 0 0 0 0 0
0 0 0 2 0 0 0 3 0 0 0
0 8 2 0 0 4 0 0 3 0 0
0 0 0 0 0 0 0 0 0 0 0
