11
17
1
1
0
0
0
0
9
3
5
30
15
10 10 10 10 10 10 10 10 10 10 10
10 10 10 10 10 10 10 10 10 10 10
10 10 10 10 10 10 10 10 10 10 10
4 4 4 4 4 4 4 4 4 4 4
5 5 5 5 5 5 5 5 5 5 5
3 3 3 3 3 3 3 3 3 3 3
9 9 9 9 4 4 4 9 9 9 9
9 5 5 9 8 8 8 9 5 5 9
9 4 4 9 10 10 10 9 3 3 9
9 10 10 10 10 10 10 10 10 10 9
9 10 10 10 10 10 10 10 10 10 9
9 10 10 10 10 10 10 10 10 10 9
9 10 10 9 5 5 5 9 10 10 9
9 8 8 9 9 9 9 9 8 8 9
10 10 10 10 10 10 10 10 10 10 10
10 10 10 10 10 10 10 10 10 10 10
10 10 10 10 10 10 10 10 10 10 10
0 0 0 0 0 0 0 0 0 0 0
0 0 0 0 0 0 0 0 0 0 0
0 0 0 0 0 0 0 0 0 0 0
0 0 0 0 0 0 0 0 0 0 2
0 2 0 2 0 0 0 0 0 0 0
0 0 0 0 0 2 0 0 1 0 0
0 0 0 0 0 0 0 0 0 0 0
0 0 2 0 0 0 0 0 1 0 0
0 0 1 0 0 0 0 0 0 0 0
0 0 0 0 0 0 0 0 0 0 0
0 0 0 0 0 0 0 0 0 0 0
0 0 0 0 0 0 0 0 0 0 0
0 0 0 0 0 2 0 0 1 0 0
0 0 2 0 0 0 0 0 2 0 0
0 0 0 0 0 0 0 0 0 0 0
0 0 0 0 0 0 0 0 0 0 0
0 0 0 0 0 0 0 0 0 0 0
0 0 0 0 0 0 0 0 0 0 0
0 0 0 0 0 0 0 0 0 0 0
0 0 0 0 0 0 0 0 0 0 0
0 0 0 0 0 0 0 0 0 0 3
0 4 0 3 0 0 0 0 0 0 0
0 0 0 0 0 6 0 0 3 0 0
0 0 0 0 0 0 0 0 0 0 0
0 0 2 0 0 0 0 0 0 0 0
0 0 0 0 0 0 0 0 0 0 0
0 0 0 0 0 0 0 0 0 0 0
0 0 0 0 0 0 0 0 0 0 0
0 0 0 0 0 0 0 0 0 0 0
0 0 0 0 0 2 0 0 0 0 0
0 0 4 0 0 0 0 0 3 0 0
0 0 0 0 0 0 0 0 0 0 0
0 0 0 0 0 0 0 0 0 0 0
0 0 0 0 0 0 0 0 0 0 0
