11
17
1
1
1
1
1
1
1
0
5
30
15
10 10 10 10 10 10 10 10 10 10 10
10 10 10 10 10 10 10 10 10 10 10
10 10 10 10 10 10 10 10 10 10 10
10 10 10 10 10 10 10 10 10 10 10
3 3 3 3 9 10 9 3 3 3 3
5 5 5 5 9 10 9 5 5 5 5
9 9 9 9 9 10 9 9 9 9 9
2 2 2 2 9 10 9 2 2 2 2
4 4 4 4 9 10 9 4 4 4 4
3 3 3 3 9 10 9 3 3 3 3
8 8 8 8 9 10 9 8 8 8 8
4 4 4 4 9 10 9 4 4 4 4
2 2 2 2 9 10 9 2 2 2 2
5 5 5 5 9 10 9 5 5 5 5
10 10 10 10 10 10 10 10 10 10 10
10 10 10 10 10 10 10 10 10 10 10
10 10 10 10 10 10 10 10 10 10 10
0 0 0 0 0 0 0 0 0 0 0
0 0 0 0 0 0 0 0 0 0 0
0 0 0 0 0 0 0 0 0 0 0
0 0 0 0 0 0 0 0 0 0 0
0 0 2 0 0 0 0 0 0 0 0
0 0 0 0 0 0 0 0 0 0 0
0 0 0 0 0 0 0 0 0 0 0
0 1 0 0 0 0 0 0 1 0 0
0 1 0 0 0 0 0 0 2 0 3
0 0 0 0 0 0 0 0 0 0 0
0 0 0 0 0 0 0 0 0 0 0
2 0 1 0 0 0 0 0 2 0 0
0 0 0 0 0 0 0 0 0 0 0
2 0 2 0 0 0 0 0 0 0 0
0 0 0 0 0 0 0 0 0 0 0
0 0 0 0 0 0 0 0 0 0 0
0 0 0 0 0 0 0 0 0 0 0
0 0 0 0 0 0 0 0 0 0 0
0 0 0 0 0 0 0 0 0 0 0
0 0 0 0 0 0 0 0 0 0 0
0 0 0 0 0 0 0 0 0 0 0
0 0 3 0 0 0 0 0 0 0 0
0 0 0 0 0 0 0 0 0 0 0
0 0 0 0 0 0 0 0 0 0 0
0 9 0 0 0 0 0 0 9 0 0
0 0 0 4 0 0 0 0 4 0 6
0 0 0 0 0 0 0 0 0 0 0
0 0 0 0 0 0 0 0 0 0 0
8 0 2 0 0 0 0 0 4 0 0
0 0 0 0 0 0 0 0 0 0 0
2 0 3 0 0 0 0 0 0 0 0
0 0 0 0 0 0 0 0 0 0 0
0 0 0 0 0 0 0 0 0 0 0
0 0 0 0 0 0 0 0 0 0 0
