11
17
1
1
1
1
1
1
5
0
5
30
15
10 10 10 10 10 10 10 10 10 10 10
10 10 10 10 10 10 10 10 10 10 10
10 10 10 10 10 10 10 10 10 10 10
3 10 4 10 5 10 2 10 3 10 4
8 10 8 10 8 10 8 10 8 10 8
10 5 10 4 10 3 10 7 10 5 10
10 8 10 8 10 8 10 8 10 8 10
7 10 3 10 4 10 5 10 2 10 3
8 10 8 10 8 10 8 10 8 10 8
10 2 10 5 10 4 10 3 10 7 10
10 8 10 8 10 8 10 8 10 8 10
5 10 7 10 3 10 4 10 5 10 2
8 10 8 10 8 10 8 10 8 10 8
10 3 10 2 10 5 10 4 10 3 10
10 8 10 8 10 8 10 8 10 8 10
4 10 5 10 7 10 3 10 4 10 5
8 10 8 10 8 10 8 10 8 10 8
0 0 0 0 0 0 0 0 0 0 0
0 0 0 0 0 0 0 0 0 0 0
0 0 0 0 0 0 0 0 0 0 0
0 0 0 0 0 0 0 0 0 0 0
0 0 0 0 0 0 0 0 0 0 0
0 0 0 2 0 0 0 2 0 0 0
0 0 0 0 0 0 0 0 0 0 0
0 0 0 0 2 0 0 0 0 0 1
0 0 0 0 0 0 0 0 0 0 0
0 0 0 0 0 0 0 1 0 0 0
0 0 0 0 0 0 0 0 0 0 0
2 0 0 0 0 0 1 0 0 0 0
0 0 0 0 0 0 0 0 0 0 0
0 0 0 0 0 1 0 2 0 0 0
0 0 0 0 0 0 0 0 0 0 0
2 0 1 0 2 0 0 0 0 0 0
0 0 0 0 0 0 0 0 0 0 0
0 0 0 0 0 0 0 0 0 0 0
0 0 0 0 0 0 0 0 0 0 0
0 0 0 0 0 0 0 0 0 0 0
0 0 0 0 0 0 0 0 0 0 0
0 0 0 0 0 0 0 0 0 0 0
0 0 0 5 0 0 0 2 0 0 0
0 0 0 0 0 0 0 0 0 0 0
0 0 0 0 6 0 0 0 0 0 6
0 0 0 0 0 0 0 0 0 0 0
0 0 0 0 0 0 0 4 0 0 0
0 0 0 0 0 0 0 0 0 0 0
4 0 0 0 0 0 2 0 0 0 0
0 0 0 0 0 0 0 0 0 0 0
0 3 0 0 0 9 0 2 0 0 0
0 0 0 0 0 0 0 0 0 0 0
0 0 0 0 3 0 0 0 1 0 0
0 0 0 0 0 0 0 0 0 0 0
