11
17
1
1
1
0
1
0
8
0
5
30
15
10 10 10 10 10 10 10 10 10 10 10
10 10 10 10 10 10 10 10 10 10 10
10 10 10 10 10 10 10 10 10 10 10
10 10 10 10 10 4 4 10 10 10 10
10 10 10 10 4 8 8 4 10 10 10
10 10 10 10 4 8 4 4 10 10 10
10 10 10 10 4 4 4 4 10 10 10
10 10 10 10 4 4 4 4 10 10 10
10 10 10 10 4 4 4 4 10 10 10
10 10 10 5 5 4 4 4 3 10 10
10 10 5 8 8 4 4 8 8 3 10
10 10 5 8 5 5 3 8 3 3 10
10 10 5 5 5 5 3 3 3 3 10
10 10 5 5 5 5 3 3 3 3 10
10 10 5 5 5 5 3 3 3 3 10
10 10 5 5 5 5 3 3 3 3 10
10 10 10 5 5 10 10 3 3 10 10
0 0 0 0 0 0 0 0 0 0 0
0 0 0 0 0 0 0 0 0 0 0
0 0 0 0 0 0 0 0 0 0 0
0 0 0 0 0 0 0 0 0 0 0
0 0 0 0 0 0 0 0 0 0 0
0 0 0 0 1 0 0 0 0 0 0
0 0 0 0 0 0 0 0 0 0 0
0 0 0 0 0 0 2 0 0 0 0
0 0 0 0 1 0 0 0 0 0 0
0 0 0 0 0 2 0 0 2 0 0
0 0 0 0 0 0 0 0 0 1 0
0 0 0 1 0 1 0 0 0 0 0
0 0 0 0 0 0 0 0 0 0 0
0 0 0 0 0 0 0 0 0 0 0
0 0 0 2 0 0 0 2 0 4 0
0 0 0 0 3 0 0 3 0 0 0
0 0 0 0 0 0 0 0 0 0 0
0 0 0 0 0 0 0 0 0 0 0
0 0 0 0 0 0 0 0 0 0 0
0 0 0 0 0 0 0 0 0 0 0
0 0 0 0 0 0 0 0 0 0 0
0 0 0 0 0 0 0 0 0 0 0
0 0 0 0 4 0 0 0 0 0 0
0 0 0 0 0 0 0 0 0 0 0
0 0 0 0 0 0 2 0 0 0 0
0 0 0 0 9 0 0 0 0 0 0
0 0 0 0 0 2 0 0 0 0 0
0 0 0 0 0 0 0 0 0 9 0
0 0 0 3 0 7 0 0 0 6 0
0 0 0 0 0 0 0 0 0 0 0
0 0 0 0 0 0 0 0 0 0 0
0 0 0 3 0 0 0 4 0 5 0
0 0 0 0 2 0 0 8 0 0 0
0 0 0 0 0 0 0 0 0 0 0
