11
17
1
0
0
1
1
0
7
0
5
30
15
10 10 10 10 10 10 10 10 10 10 10
10 10 10 10 10 10 10 10 10 10 10
10 10 10 10 10 10 6 6 6 10 10
10 10 10 10 10 10 6 6 2 10 10
10 10 10 10 10 6 6 2 2 2 10
10 10 10 10 10 6 6 6 2 3 10
10 10 10 10 10 6 6 6 6 3 10
10 10 10 10 9 6 6 6 6 3 10
10 10 10 10 7 3 6 6 3 3 10
10 10 10 10 7 7 3 3 3 10 10
10 10 10 9 7 9 3 3 3 10 10
10 10 10 7 7 7 7 10 10 10 10
10 10 9 7 9 7 10 10 10 10 10
10 10 7 7 7 7 10 10 10 10 10
10 10 7 7 7 10 10 10 10 10 10
10 7 7 7 10 10 10 10 10 10 10
10 7 7 10 10 10 10 10 10 10 10
0 0 0 0 0 0 0 0 0 0 0
0 0 0 0 0 0 0 0 0 0 0
0 0 0 0 0 0 0 0 0 0 0
0 0 0 0 0 0 0 0 0 0 0
0 0 0 0 0 0 2 2 0 0 0
0 0 0 0 0 0 1 0 1 0 0
0 0 0 0 0 0 2 2 0 0 0
0 0 0 0 0 2 0 0 0 0 0
0 0 0 0 0 0 0 0 0 0 0
0 0 0 0 0 0 2 1 0 0 0
0 0 0 0 2 0 0 0 0 0 0
0 0 0 0 1 0 0 0 0 0 0
0 0 0 1 0 2 0 0 0 0 0
0 0 0 0 0 0 0 0 0 0 0
0 0 1 1 0 0 0 0 0 0 0
0 0 0 0 0 0 0 0 0 0 0
0 0 2 0 0 0 0 0 0 0 0
0 0 0 0 0 0 0 0 0 0 0
0 0 0 0 0 0 0 0 0 0 0
0 0 0 0 0 0 0 0 0 0 0
0 0 0 0 0 0 0 0 0 0 0
0 0 0 0 0 0 2 1 0 0 0
0 0 0 0 0 0 0 0 4 0 0
0 0 0 0 0 0 2 1 0 0 0
0 0 0 0 0 4 3 0 0 0 0
0 0 0 0 0 0 0 0 0 0 0
0 0 0 0 0 0 1 2 0 0 0
0 0 0 0 2 0 0 0 0 0 0
0 0 0 0 2 0 0 0 0 0 0
0 0 0 6 0 6 0 0 0 0 0
0 0 0 0 0 0 0 0 0 0 0
0 0 2 0 0 0 0 0 0 0 0
0 0 0 0 0 0 0 0 0 0 0
0 0 8 0 0 0 0 0 0 0 0
