13
19
1
1
0
0
0
0
6
2
5
15
30
10 10 10 10 10 10 10 10 10 10 10 10 10
10 10 10 10 10 10 10 10 10 10 10 10 10
10 10 10 10 10 10 10 10 10 10 10 10 10
10 8 0 8 3 8 4 4 4 4 4 4 10
10 3 8 3 8 3 0 0 0 0 0 0 10
10 8 3 8 3 8 4 4 4 4 4 4 10
10 3 8 3 8 3 0 0 0 0 0 0 10
10 8 3 8 3 8 4 4 4 4 4 4 10
10 0 0 0 0 0 0 0 0 0 0 0 10
10 4 4 4 4 4 4 4 4 4 4 4 10
10 0 0 0 0 0 0 0 0 0 0 0 10
10 4 4 4 4 4 4 4 4 4 4 4 10
10 0 0 0 0 0 0 0 0 0 0 0 10
10 4 4 4 4 4 4 4 4 4 4 4 10
10 10 10 10 10 10 10 10 10 10 10 10 10
10 10 10 10 10 10 10 10 10 10 10 10 10
10 10 10 10 10 10 10 10 10 10 10 10 10
10 10 10 10 10 10 10 10 10 10 10 10 10
10 10 10 10 10 10 10 10 10 10 10 10 10
0 0 0 0 0 0 0 0 0 0 0 0 0
0 0 0 0 0 0 0 0 0 0 0 0 0
0 0 0 0 0 0 0 0 0 0 0 0 0
0 0 0 0 2 6 0 0 0 0 0 0 0
0 0 6 0 0 0 0 0 0 0 0 0 0
0 0 0 0 0 0 0 0 6 0 0 0 0
0 0 0 0 0 4 0 4 0 0 0 0 0
0 0 0 5 6 0 0 0 7 0 0 0 0
0 0 0 0 0 0 0 0 0 0 0 0 0
0 0 0 0 5 0 0 0 2 0 0 0 0
0 0 0 0 0 0 0 0 0 0 0 0 0
0 0 0 0 0 0 0 0 0 0 0 0 0
0 0 0 0 0 0 0 0 0 0 2 0 0
0 0 0 0 4 0 0 0 1 0 0 0 0
0 0 0 0 0 0 0 0 0 0 0 0 0
0 0 0 0 0 0 0 0 0 0 0 0 0
0 0 0 0 0 0 0 0 0 0 0 0 0
0 0 0 0 0 0 0 0 0 0 0 0 0
0 0 0 0 0 0 0 0 0 0 0 0 0
0 0 0 0 0 0 0 0 0 0 0 0 0
0 0 0 0 0 0 0 0 0 0 0 0 0
0 0 0 0 0 0 0 0 0 0 0 0 0
0 0 0 0 2 3 0 0 4 0 0 0 0
0 0 5 0 0 0 0 0 0 0 0 0 0
0 0 0 0 0 10 0 0 4 0 0 0 0
0 0 0 0 0 11 0 9 0 0 11 0 0
0 0 0 15 9 0 0 0 1 0 0 0 0
0 0 0 0 0 0 0 0 0 0 0 0 0
0 0 0 0 15 0 0 0 10 0 0 0 0
0 0 0 0 0 0 0 0 0 0 0 0 0
0 0 0 9 0 0 0 0 0 0 0 0 0
0 0 0 0 0 0 0 0 0 0 15 0 0
0 0 0 0 15 5 0 0 1 0 0 0 0
0 0 0 0 0 0 0 0 0 0 0 0 0
0 0 0 0 0 0 0 0 0 0 0 0 0
0 0 0 0 0 0 0 0 0 0 0 0 0
0 0 0 0 0 0 0 0 0 0 0 0 0
0 0 0 0 0 0 0 0 0 0 0 0 0
