13
19
1
1
0
0
0
0
4
0
5
15
30
10 10 10 10 10 10 10 10 10 10 10 10 10
10 10 10 10 10 10 10 10 10 10 10 10 10
10 10 10 10 10 10 10 10 10 10 10 10 10
9 9 9 9 9 9 9 9 9 9 9 9 9
10 10 10 10 10 10 9 10 10 10 10 10 10
10 7 7 7 7 7 9 7 7 7 7 7 10
10 10 10 10 10 10 9 10 10 10 10 10 10
5 5 5 10 9 9 9 9 9 10 5 5 5
10 10 10 10 10 10 9 10 10 10 10 10 10
10 4 4 4 4 4 9 4 4 4 4 4 10
10 10 10 10 10 10 9 10 10 10 10 10 10
9 9 9 10 10 10 9 10 10 10 9 9 9
10 10 10 10 10 10 9 10 10 10 10 10 10
10 3 3 3 3 3 9 3 3 3 3 3 10
10 10 10 10 10 10 9 10 10 10 10 10 10
0 0 10 9 9 9 9 9 9 9 10 0 0
10 10 10 10 10 10 10 10 10 10 10 10 10
10 10 10 10 10 10 10 10 10 10 10 10 10
10 10 10 10 10 10 10 10 10 10 10 10 10
0 0 0 0 0 0 0 0 0 0 0 0 0
0 0 0 0 0 0 0 0 0 0 0 0 0
0 0 0 0 0 0 0 0 0 0 0 0 0
0 3 0 0 5 0 0 0 0 0 0 0 0
0 0 0 0 0 0 2 0 0 0 0 0 0
0 0 0 0 6 0 0 0 0 0 4 0 0
0 0 0 0 0 0 1 0 0 0 0 0 0
0 0 0 0 3 0 6 0 7 0 1 0 0
0 0 0 0 0 0 0 0 0 0 0 0 0
0 0 5 1 5 0 0 0 0 0 0 0 0
0 0 0 0 0 0 0 0 0 0 0 0 0
0 0 0 0 0 0 5 0 0 0 0 0 0
0 0 0 0 0 0 0 0 0 0 0 0 0
0 0 0 0 0 0 0 0 0 0 0 0 0
0 0 0 0 0 0 6 0 0 0 0 0 0
3 6 0 0 0 0 0 0 0 0 0 0 0
0 0 0 0 0 0 0 0 0 0 0 0 0
0 0 0 0 0 0 0 0 0 0 0 0 0
0 0 0 0 0 0 0 0 0 0 0 0 0
0 0 0 0 0 0 0 0 0 0 0 0 0
0 0 0 0 0 0 0 0 0 0 0 0 0
0 0 0 0 0 0 0 0 0 0 0 0 0
0 1 0 0 4 0 0 0 0 0 0 0 0
0 0 0 0 0 0 1 0 0 0 0 0 0
0 3 0 0 13 0 0 15 0 0 10 0 0
0 0 0 0 0 0 0 0 0 0 0 0 0
0 0 0 0 9 0 6 0 10 0 3 0 0
0 0 0 0 0 0 0 0 0 0 0 0 0
0 2 6 4 14 0 0 0 0 0 0 0 0
0 0 0 0 0 0 0 0 0 0 0 0 0
0 0 0 0 0 0 10 0 0 0 0 0 0
0 0 0 0 0 0 0 0 0 0 0 0 0
0 0 0 0 0 0 0 0 0 0 0 0 0
0 0 0 0 0 0 10 0 0 0 0 0 0
4 4 0 13 0 0 0 0 0 0 0 0 0
0 0 0 0 0 0 0 0 0 0 0 0 0
0 0 0 0 0 0 0 0 0 0 0 0 0
0 0 0 0 0 0 0 0 0 0 0 0 0
