13
19
1
1
0
0
0
0
4
0
5
15
30
10 10 10 10 10 10 10 10 10 10 10 10 10
10 10 10 10 10 10 10 10 10 10 10 10 10
10 9 9 9 9 9 10 9 9 9 9 9 10
10 9 9 9 9 9 10 9 9 9 9 9 10
10 9 9 9 9 9 10 9 9 9 9 9 10
10 9 9 9 9 9 10 9 9 9 9 19 10
10 19 9 9 9 9 10 9 9 9 9 9 10
10 9 9 9 9 10 10 10 9 9 9 9 10
10 9 9 9 10 0 7 6 10 9 9 19 10
10 9 9 10 2 1 0 7 6 10 9 9 10
10 9 10 4 3 2 1 0 7 6 10 9 10
10 19 10 5 4 3 2 1 0 7 10 9 10
10 9 10 6 5 4 3 2 1 0 10 9 10
10 9 9 10 6 5 4 3 2 10 9 9 10
10 9 9 9 10 6 5 4 10 9 9 9 10
10 9 9 9 9 10 10 10 9 9 9 9 10
10 19 9 9 9 9 9 9 9 9 9 9 10
10 9 9 9 9 9 9 9 9 9 9 9 10
10 10 10 10 10 10 10 10 10 10 10 10 10
0 0 0 0 0 0 0 0 0 0 0 0 0
0 0 0 0 0 0 0 0 0 0 0 0 0
0 0 0 0 4 5 0 3 0 1 0 0 0
0 0 0 0 4 0 0 0 0 0 0 0 0
0 0 0 0 0 0 0 0 0 0 0 0 0
0 0 0 4 0 7 0 0 2 0 0 0 0
0 0 0 0 0 0 0 0 0 6 0 0 0
0 0 0 0 0 0 0 0 0 0 0 0 0
0 2 0 2 0 0 0 2 0 0 0 0 0
0 0 0 0 0 7 0 0 4 0 0 0 0
0 0 0 0 7 2 0 7 0 5 0 0 0
0 0 0 4 0 0 7 6 0 0 0 0 0
0 0 0 0 0 0 0 0 0 0 0 7 0
0 0 0 0 6 0 0 0 0 0 0 0 0
0 0 0 0 0 0 0 0 0 0 0 0 0
0 0 0 0 0 0 0 0 6 0 7 0 0
0 2 0 0 0 0 2 0 0 0 0 6 0
0 4 0 0 3 0 3 0 0 0 0 0 0
0 0 0 0 0 0 0 0 0 0 0 0 0
0 0 0 0 0 0 0 0 0 0 0 0 0
0 0 0 0 0 0 0 0 0 0 0 0 0
0 0 0 0 5 7 0 5 0 1 0 0 0
0 0 0 0 7 0 0 0 0 0 0 0 0
0 0 0 0 0 0 0 0 0 0 0 0 0
0 0 0 10 0 13 0 4 10 0 0 0 0
0 0 0 0 0 0 0 0 3 12 0 0 0
0 0 0 0 0 0 0 0 0 0 0 0 0
0 10 0 15 0 0 0 1 0 0 0 0 0
0 0 0 0 0 9 0 0 2 0 15 12 0
0 0 0 0 1 2 8 4 0 11 0 0 0
0 0 0 10 0 0 5 14 0 0 0 0 0
0 0 0 0 0 0 0 0 0 0 0 7 0
0 13 0 0 13 0 0 0 0 0 0 0 0
0 0 0 0 0 0 0 0 0 0 0 0 0
0 0 0 0 0 0 0 0 9 0 8 0 0
0 8 0 0 0 0 6 0 0 0 0 14 0
0 3 0 0 7 0 13 0 0 0 0 0 0
0 0 0 0 0 0 0 0 0 0 0 0 0
