13
19
1
1
0
0
0
0
3
1
5
30
15
10 10 10 10 10 10 10 10 10 10 10 10 10
10 10 10 10 10 10 10 10 10 10 10 10 10
10 10 10 10 10 10 10 10 10 10 10 10 10
10 10 10 10 10 10 10 10 10 10 10 10 10
10 10 10 8 8 10 10 10 8 8 10 10 10
10 10 8 3 3 8 10 8 3 3 8 10 10
10 10 8 3 3 8 10 8 3 3 8 10 10
10 10 10 8 8 10 10 10 8 8 10 10 10
10 10 10 10 10 10 10 10 10 10 10 10 10
10 10 8 8 10 10 10 10 10 8 8 10 10
10 8 4 4 8 10 10 10 8 4 4 8 10
10 8 4 4 8 10 10 10 8 4 4 8 10
10 10 8 8 10 10 8 10 10 8 8 10 10
10 10 10 10 10 8 5 8 10 10 10 10 10
10 8 8 10 10 8 5 8 10 10 8 8 10
8 1 1 8 10 10 8 10 10 8 1 1 8
8 1 1 8 10 10 10 10 10 8 1 1 8
10 8 8 10 10 10 10 10 10 10 8 8 10
10 10 10 10 10 10 10 10 10 10 10 10 10
0 0 0 0 0 0 0 0 0 0 0 0 0
0 0 0 0 0 0 0 0 0 0 0 0 0
0 0 0 0 0 0 0 0 0 0 0 0 0
0 0 0 0 0 0 0 0 0 0 0 0 0
0 0 0 6 0 0 0 0 7 0 0 0 0
0 0 0 0 0 4 0 1 0 0 0 0 0
0 0 0 0 0 0 0 0 0 0 0 0 0
0 0 0 0 0 0 0 0 0 0 0 0 0
0 0 0 0 0 0 0 0 0 0 0 0 0
0 0 0 0 0 0 0 0 0 0 0 0 0
0 5 2 6 0 0 0 0 7 0 0 0 0
0 0 0 0 0 0 0 0 0 0 0 0 0
0 0 0 1 0 0 0 0 0 0 0 0 0
0 0 0 0 0 0 0 0 0 0 0 0 0
0 0 0 0 0 0 0 0 0 0 0 0 0
0 0 0 0 0 0 0 0 0 0 0 0 0
0 0 0 0 0 0 0 0 0 0 0 0 0
0 5 6 0 0 0 0 0 0 0 0 0 0
0 0 0 0 0 0 0 0 0 0 0 0 0
0 0 0 0 0 0 0 0 0 0 0 0 0
0 0 0 0 0 0 0 0 0 0 0 0 0
0 0 0 0 0 0 0 0 0 0 0 0 0
0 0 0 0 0 0 0 0 0 0 0 0 0
0 0 0 2 0 0 0 0 9 0 0 0 0
0 0 0 0 0 5 0 10 0 0 0 0 0
0 0 0 0 0 0 0 0 0 0 0 0 0
0 0 0 0 0 0 0 0 0 0 0 0 0
0 0 0 0 0 0 0 0 0 0 0 0 0
0 0 0 0 0 0 0 0 0 0 0 0 0
0 15 15 2 0 0 0 0 13 0 0 0 0
0 0 0 0 0 0 0 0 0 0 0 0 0
0 0 0 7 0 0 0 0 0 0 0 0 0
0 0 0 0 0 0 0 0 0 0 0 0 0
0 0 0 0 0 0 0 0 0 0 0 0 0
0 0 0 0 0 0 0 0 0 0 0 0 0
0 0 0 0 0 0 0 0 0 0 0 0 0
0 7 9 0 0 0 0 0 0 0 0 0 0
0 0 0 0 0 0 0 0 0 0 0 0 0
