13
19
1
1
0
0
0
0
6
0
5
15
30
10 10 10 10 10 10 10 10 10 10 10 10 10
10 10 10 10 10 10 10 10 10 10 10 10 10
10 10 10 10 10 10 10 10 10 10 10 10 10
10 10 10 10 10 10 10 10 10 10 10 10 10
10 10 10 10 10 7 7 7 10 10 10 10 10
10 10 10 10 7 7 7 7 7 10 10 10 10
10 10 10 7 7 7 3 3 7 7 10 10 10
10 10 8 7 7 3 3 3 3 7 8 10 10
10 7 8 7 3 3 3 3 3 7 8 7 10
7 7 8 7 7 3 7 3 3 7 8 7 7
10 7 8 7 7 3 7 3 3 7 8 7 10
10 10 8 7 7 3 3 3 7 7 8 10 10
10 10 10 7 7 7 7 7 7 7 10 10 10
10 10 10 10 7 7 7 7 7 10 10 10 10
10 10 10 10 10 7 7 7 10 10 10 10 10
10 10 10 10 10 10 10 10 10 10 10 10 10
10 10 10 10 10 10 10 10 10 10 10 10 10
10 10 10 10 10 10 10 10 10 10 10 10 10
10 10 10 10 10 10 10 10 10 10 10 10 10
0 0 0 0 0 0 0 0 0 0 0 0 0
0 0 0 0 0 0 0 0 0 0 0 0 0
0 0 0 0 0 0 0 0 0 0 0 0 0
0 0 0 0 0 0 0 0 0 0 0 0 0
0 0 0 0 0 0 0 0 0 0 0 0 0
0 0 0 0 0 0 0 0 0 0 0 0 0
0 0 0 0 0 1 0 0 0 0 0 0 0
0 0 0 0 0 0 0 0 0 0 0 0 0
0 0 0 0 0 0 0 0 0 0 0 0 0
0 0 0 0 0 1 0 0 0 0 2 3 0
0 0 0 0 0 0 0 0 0 0 0 0 0
0 0 0 2 0 0 0 3 6 0 0 0 0
0 0 0 0 0 0 0 0 2 0 0 0 0
0 0 0 0 0 0 0 0 3 0 0 0 0
0 0 0 0 0 0 0 0 0 0 0 0 0
0 0 0 0 0 0 0 0 0 0 0 0 0
0 0 0 0 0 0 0 0 0 0 0 0 0
0 0 0 0 0 0 0 0 0 0 0 0 0
0 0 0 0 0 0 0 0 0 0 0 0 0
0 0 0 0 0 0 0 0 0 0 0 0 0
0 0 0 0 0 0 0 0 0 0 0 0 0
0 0 0 0 0 0 0 0 0 0 0 0 0
0 0 0 0 0 0 0 0 0 0 0 0 0
0 0 0 0 0 0 0 0 0 0 0 0 0
0 0 0 0 0 0 0 0 0 0 0 0 0
0 0 0 0 0 3 0 0 0 0 0 0 0
0 0 0 0 0 0 0 0 0 0 0 0 0
0 0 0 0 0 0 0 0 0 0 0 0 0
0 0 14 0 0 14 0 0 0 0 14 15 0
0 0 0 0 12 0 0 0 0 0 0 0 0
0 0 0 8 0 0 0 11 5 0 0 0 0
0 0 0 0 0 0 0 0 3 0 0 0 0
0 0 0 0 0 0 0 11 6 0 0 0 0
0 0 0 0 0 0 0 0 0 0 0 0 0
0 0 0 0 0 0 0 0 0 0 0 0 0
0 0 0 0 0 0 0 0 0 0 0 0 0
0 0 0 0 0 0 0 0 0 0 0 0 0
0 0 0 0 0 0 0 0 0 0 0 0 0
