13
19
1
1
0
0
0
0
5
0
5
15
30
10 10 10 10 10 10 10 10 10 10 10 10 10
10 10 10 10 10 10 10 10 10 10 10 10 10
10 10 10 10 10 10 10 10 10 10 10 10 10
10 10 10 10 10 10 10 10 10 10 10 10 10
19 19 19 10 19 19 19 19 19 10 19 19 19
19 19 19 10 19 19 19 19 19 10 19 19 19
19 19 19 10 19 19 19 19 19 10 19 19 19
19 19 19 10 19 19 19 19 19 10 19 19 19
10 10 10 10 10 10 10 10 10 10 10 10 10
1 1 10 10 1 1 10 1 1 10 10 1 1
10 10 8 8 10 10 9 10 10 8 8 10 10
2 2 10 10 2 2 10 2 2 10 10 2 2
10 10 8 8 10 10 9 10 10 8 8 10 10
5 5 10 10 5 5 10 5 5 10 10 5 5
10 10 8 8 10 10 9 10 10 8 8 10 10
6 6 10 10 6 6 10 6 6 10 10 6 6
10 10 8 8 10 10 9 10 10 8 8 10 10
4 4 10 10 4 4 10 4 4 10 10 4 4
10 10 10 10 10 10 10 10 10 10 10 10 10
0 0 0 0 0 0 0 0 0 0 0 0 0
0 0 0 0 0 0 0 0 0 0 0 0 0
0 0 0 0 0 0 0 0 0 0 0 0 0
0 0 0 0 0 0 0 0 0 0 0 0 0
0 0 0 0 0 0 0 0 0 0 3 0 0
0 0 0 0 0 0 0 0 3 0 3 6 0
0 0 0 0 0 0 2 7 0 0 7 0 0
0 0 0 0 0 0 0 0 0 0 0 0 0
0 0 0 0 0 0 0 0 0 0 0 0 0
0 0 0 0 0 0 0 0 7 0 0 0 0
0 0 0 0 0 0 0 0 0 4 0 0 0
0 0 0 0 0 0 0 7 0 0 0 0 0
0 0 0 0 0 0 5 0 0 7 0 0 0
0 0 0 0 0 0 0 0 0 0 0 0 0
0 0 0 0 0 0 0 0 0 0 0 0 0
0 0 0 0 0 0 0 0 0 0 0 0 0
0 0 0 0 0 0 6 0 0 0 1 0 0
0 1 0 0 0 0 0 0 0 0 0 0 0
0 0 0 0 0 0 0 0 0 0 0 0 0
0 0 0 0 0 0 0 0 0 0 0 0 0
0 0 0 0 0 0 0 0 0 0 0 0 0
0 0 0 0 0 0 0 0 0 0 0 0 0
0 0 0 0 0 0 0 0 0 0 0 0 0
0 0 0 0 0 0 0 0 0 0 14 0 0
0 0 0 0 0 0 0 0 2 0 2 2 0
0 0 0 0 0 0 8 10 0 0 15 0 0
0 0 0 0 0 0 0 0 0 0 5 0 0
0 0 0 0 0 0 0 0 0 0 0 0 0
0 0 0 0 0 0 0 0 5 0 0 0 0
0 0 0 0 0 0 0 0 0 0 0 0 0
0 0 0 0 0 0 0 1 0 0 0 0 0
0 0 0 0 0 0 2 0 0 0 0 0 0
0 0 0 0 0 0 0 0 0 0 0 0 0
0 0 0 0 0 0 0 0 0 0 0 0 0
0 0 0 0 0 0 0 0 0 0 0 0 0
0 0 0 6 0 0 7 0 0 0 7 0 0
0 10 0 0 0 0 0 0 0 0 0 0 0
0 0 0 0 0 0 0 0 0 0 0 0 0
