13
19
1
1
0
0
0
0
6
2
5
30
15
10 10 10 10 10 10 10 10 10 10 10 10 10
10 10 10 10 10 10 10 10 10 10 10 10 10
10 10 10 10 10 10 10 10 10 10 10 10 10
10 10 10 10 10 10 10 10 10 10 10 10 10
10 10 10 10 0 0 7 7 6 10 10 10 10
10 10 10 8 0 7 7 6 6 8 10 10 10
10 10 10 10 7 7 6 6 5 10 10 10 10
10 10 10 8 7 6 6 5 5 8 10 10 10
10 10 10 10 6 6 5 5 4 10 10 10 10
10 10 10 8 6 5 5 4 4 8 10 10 10
10 10 10 10 5 5 4 4 3 10 10 10 10
10 10 10 8 5 4 4 3 3 8 10 10 10
10 10 10 10 4 4 3 3 2 10 10 10 10
10 10 10 8 4 3 3 2 2 8 10 10 10
10 10 10 10 3 3 2 2 1 10 10 10 10
10 10 10 8 3 2 2 1 1 8 10 10 10
10 10 10 10 2 2 1 1 0 10 10 10 10
10 10 10 8 2 1 1 0 0 8 10 10 10
10 10 10 10 1 1 0 0 7 10 10 10 10
0 0 0 0 0 0 0 0 0 0 0 0 0
0 0 0 0 0 0 0 0 0 0 0 0 0
0 0 0 0 0 0 0 0 0 0 0 0 0
0 0 0 0 0 0 0 0 0 0 0 0 0
0 0 0 0 0 0 0 0 0 0 0 0 0
0 0 0 0 0 0 6 0 0 0 0 0 0
0 0 0 0 0 0 0 4 0 0 0 0 0
0 0 0 0 0 0 0 0 0 0 0 0 0
0 0 0 0 0 0 0 0 0 0 0 0 0
0 0 0 0 0 0 0 0 0 0 0 0 0
0 0 0 0 0 3 0 0 0 0 0 0 0
0 0 0 0 0 2 0 0 0 0 0 0 0
0 0 0 0 0 0 0 0 0 0 0 0 0
0 0 0 0 0 0 0 0 0 0 0 0 0
0 0 0 0 0 0 0 1 1 0 0 0 0
0 0 0 0 0 0 0 0 0 5 0 0 0
0 0 0 0 0 1 0 6 0 0 0 0 0
0 0 0 0 0 0 0 0 0 0 0 0 0
0 0 0 0 0 0 0 0 0 0 0 0 0
0 0 0 0 0 0 0 0 0 0 0 0 0
0 0 0 0 0 0 0 0 0 0 0 0 0
0 0 0 0 0 0 0 0 0 0 0 0 0
0 0 0 0 0 0 0 0 0 0 0 0 0
0 0 0 0 0 0 0 2 0 0 0 0 0
0 0 0 0 8 0 0 0 0 0 0 0 0
0 0 0 0 0 0 0 10 0 0 0 0 0
0 0 0 0 0 0 0 0 0 0 0 0 0
0 0 0 0 0 0 0 0 0 0 0 0 0
0 0 0 0 0 0 0 0 0 0 0 0 0
0 0 0 0 0 8 0 0 0 0 0 0 0
0 0 0 0 0 1 0 0 0 0 0 0 0
0 0 0 0 0 0 0 0 0 0 0 0 0
0 0 0 0 0 0 0 0 0 0 0 0 0
0 0 0 0 0 0 0 7 4 0 0 0 0
0 0 0 0 0 0 0 0 0 13 0 0 0
0 0 0 0 0 10 2 0 0 0 0 0 0
0 0 0 0 0 0 0 0 0 0 0 0 0
0 0 0 0 0 0 0 0 0 0 0 0 0
