13
19
1
1
0
0
0
0
6
2
5
30
15
10 10 10 10 10 10 10 10 10 10 10 10 10
10 10 10 10 10 10 10 10 10 10 10 10 10
10 10 10 10 10 10 10 10 10 10 10 10 10
10 10 10 10 10 10 8 10 10 10 10 10 10
10 10 10 10 10 10 8 10 10 10 10 10 10
10 10 10 10 10 8 1 8 10 10 10 10 10
10 10 10 10 10 8 1 8 10 10 10 10 10
10 10 10 8 8 1 1 1 8 8 10 10 10
8 8 8 1 1 1 1 1 1 1 8 8 8
10 8 1 1 1 1 1 1 1 1 1 8 10
10 10 8 1 1 1 1 1 1 1 8 10 10
10 10 10 8 1 1 1 1 1 8 10 10 10
10 10 10 10 8 1 1 1 8 10 10 10 10
10 10 10 8 1 1 8 1 1 8 10 10 10
10 10 8 1 1 8 10 8 1 1 8 10 10
10 8 1 1 8 10 10 10 8 1 1 8 10
10 8 8 8 10 10 10 10 10 8 8 8 10
8 10 10 10 10 10 10 10 10 10 10 10 8
10 10 10 10 10 10 10 10 10 10 10 10 10
0 0 0 0 0 0 0 0 0 0 0 0 0
0 0 0 0 0 0 0 0 0 0 0 0 0
0 0 0 0 0 0 0 0 0 0 0 0 0
0 0 0 0 0 0 0 0 0 0 0 0 0
0 0 0 0 0 0 0 0 0 0 0 0 0
0 0 0 0 0 0 0 0 0 0 0 0 0
0 0 0 0 0 0 0 0 0 0 0 0 0
0 0 0 0 0 0 0 0 0 0 0 0 0
0 0 0 0 0 0 0 0 0 0 0 0 0
0 0 0 0 0 0 0 0 0 0 0 0 0
0 0 0 0 3 0 0 0 2 0 0 0 0
0 0 0 0 3 0 6 0 0 0 0 0 0
0 0 0 0 3 0 0 0 0 0 0 0 0
0 0 0 0 5 0 0 0 0 0 0 0 0
0 0 0 0 0 0 0 5 0 0 0 0 0
0 4 0 0 0 0 0 0 0 0 0 0 0
0 6 0 0 0 0 0 0 0 0 0 0 0
5 0 0 0 0 0 0 0 0 0 0 0 0
0 0 0 0 0 0 0 0 0 0 0 0 0
0 0 0 0 0 0 0 0 0 0 0 0 0
0 0 0 0 0 0 0 0 0 0 0 0 0
0 0 0 0 0 0 0 0 0 0 0 0 0
0 0 0 0 0 0 0 0 0 0 0 0 0
0 0 0 0 0 0 0 0 0 0 0 0 0
0 0 0 0 0 0 0 0 0 0 0 0 0
0 0 0 0 0 0 0 0 0 0 0 0 0
0 0 0 0 0 0 0 0 0 0 0 0 0
0 0 0 0 0 0 0 0 0 0 0 0 0
0 0 0 0 0 0 0 0 0 0 0 0 0
0 0 0 0 9 0 0 0 13 0 0 0 0
0 0 0 0 3 0 8 0 0 0 0 0 0
0 0 0 0 5 0 0 0 0 0 0 0 0
0 0 0 0 6 0 0 0 0 0 0 0 0
0 0 0 0 0 0 0 14 0 0 0 0 0
0 10 0 0 0 0 0 0 0 0 0 0 0
0 9 4 0 0 0 0 0 0 0 8 0 0
9 0 0 0 0 0 0 0 0 0 0 0 0
0 0 0 0 0 0 0 0 0 0 0 0 0
