13
19
1
1
0
0
0
0
4
3
5
30
15
10 10 10 10 10 10 10 10 10 10 10 10 10
10 10 10 10 10 10 10 10 10 10 10 10 10
10 10 10 10 10 10 10 10 10 10 10 10 10
10 10 10 10 10 10 10 10 10 10 10 10 10
9 9 9 9 9 9 9 9 9 9 9 9 9
9 9 9 9 9 9 9 9 9 9 9 9 9
9 9 9 9 9 9 9 9 9 9 9 9 9
9 9 9 9 9 9 9 9 9 9 9 9 9
9 9 9 9 9 9 9 9 9 9 9 9 9
9 9 9 9 9 9 9 9 9 9 9 9 9
9 9 9 9 9 9 9 9 9 9 9 9 9
10 10 10 10 10 10 10 10 10 10 10 10 10
10 7 10 6 10 5 10 4 10 3 10 2 10
10 8 10 8 10 8 10 8 10 8 10 8 10
10 8 10 8 10 8 10 8 10 8 10 8 10
10 8 10 8 10 8 10 8 10 8 10 8 10
10 8 10 8 10 8 10 8 10 8 10 8 10
10 7 10 6 10 5 10 4 10 3 10 2 10
10 10 10 10 10 10 10 10 10 10 10 10 10
0 0 0 0 0 0 0 0 0 0 0 0 0
0 0 0 0 0 0 0 0 0 0 0 0 0
0 0 0 0 0 0 0 0 0 0 0 0 0
0 0 0 0 0 0 0 0 0 0 0 0 0
1 0 0 0 3 0 0 7 0 0 0 0 0
0 2 5 2 4 0 3 0 0 0 0 0 0
3 0 0 0 0 0 1 0 7 0 0 4 0
4 5 3 0 0 0 4 7 0 2 0 0 0
0 0 4 0 0 0 0 4 6 0 0 0 0
2 2 0 0 0 0 0 0 0 0 0 0 0
7 0 0 5 0 0 0 0 0 0 0 0 0
0 0 0 0 0 0 0 0 0 0 0 0 0
0 0 0 0 0 0 0 2 0 3 0 0 0
0 0 0 1 0 0 0 0 0 0 0 3 0
0 0 0 6 0 0 0 0 0 4 0 5 0
0 0 0 0 0 0 0 1 0 0 0 0 0
0 2 0 0 0 0 0 0 0 0 0 0 0
0 2 0 0 0 5 0 0 0 0 0 0 0
0 0 0 0 0 0 0 0 0 0 0 0 0
0 0 0 0 0 0 0 0 0 0 0 0 0
0 0 0 0 0 0 0 0 0 0 0 0 0
0 0 0 0 0 0 0 0 0 0 0 0 0
0 0 0 0 0 0 0 0 0 0 0 0 0
4 0 0 0 0 0 0 1 0 0 0 0 0
0 4 8 15 8 0 0 0 0 0 0 0 0
15 0 0 0 0 0 5 0 3 0 0 4 0
8 8 0 1 0 0 8 11 0 10 0 0 0
0 0 9 0 0 0 15 8 15 0 0 0 0
5 15 0 0 0 0 0 0 0 1 0 0 0
1 0 0 1 0 0 0 0 0 0 0 0 0
0 0 0 0 0 0 0 0 0 0 0 0 0
0 0 0 8 0 0 0 0 0 4 0 0 0
0 0 0 8 0 0 0 0 0 0 0 8 0
0 0 0 2 0 0 0 0 0 15 0 0 0
0 0 0 0 0 0 0 15 0 0 0 0 0
0 7 0 0 0 0 0 0 0 0 0 0 0
0 4 0 0 0 14 0 0 0 0 0 0 0
0 0 0 0 0 0 0 0 0 0 0 0 0
