13
19
1
1
0
0
0
0
2
1
5
30
15
10 10 10 10 10 10 10 10 10 10 10 10 10
10 10 10 10 10 10 10 10 10 10 10 10 10
10 10 10 10 10 10 10 10 10 10 10 10 10
10 10 10 10 10 10 10 10 10 10 10 10 10
10 9 5 9 5 9 5 9 5 9 5 9 10
10 9 9 9 9 9 9 9 9 9 9 9 10
10 4 10 4 10 4 10 4 10 4 10 4 10
10 9 10 9 10 9 10 9 10 9 10 9 10
10 9 10 9 10 9 10 9 10 9 10 9 10
10 2 10 2 10 2 10 2 10 2 10 2 10
10 9 10 9 10 9 10 9 10 9 10 9 10
10 9 10 9 10 9 10 9 10 9 10 9 10
10 1 10 1 10 1 10 1 10 1 10 1 10
10 9 10 9 10 9 10 9 10 9 10 10 10
10 9 10 9 10 9 10 9 10 10 10 10 10
10 9 10 9 10 9 10 10 10 10 10 10 10
10 9 10 9 10 10 10 10 10 10 10 10 10
10 9 10 10 10 10 10 10 10 10 10 10 10
10 10 10 10 10 10 10 10 10 10 10 10 10
0 0 0 0 0 0 0 0 0 0 0 0 0
0 0 0 0 0 0 0 0 0 0 0 0 0
0 0 0 0 0 0 0 0 0 0 0 0 0
0 0 0 0 0 0 0 0 0 0 0 0 0
0 0 5 0 0 5 0 2 0 0 7 0 0
0 7 0 0 4 0 0 0 5 0 0 4 0
0 0 0 5 0 0 0 0 0 0 0 0 0
0 0 0 0 0 2 0 0 0 4 0 0 0
0 5 0 7 0 5 0 0 0 6 0 6 0
0 1 0 0 0 5 0 0 0 0 0 5 0
0 0 0 6 0 0 0 0 0 0 0 5 0
0 0 0 0 0 0 0 6 0 0 0 0 0
0 0 0 0 0 0 0 0 0 0 0 4 0
0 7 0 3 0 1 0 0 0 0 0 0 0
0 0 0 7 0 0 0 0 0 0 0 0 0
0 3 0 0 0 0 0 0 0 0 0 0 0
0 0 0 0 0 0 0 0 0 0 0 0 0
0 5 0 0 0 0 0 0 0 0 0 0 0
0 0 0 0 0 0 0 0 0 0 0 0 0
0 0 0 0 0 0 0 0 0 0 0 0 0
0 0 0 0 0 0 0 0 0 0 0 0 0
0 0 0 0 0 0 0 0 0 0 0 0 0
0 0 0 0 0 0 0 0 0 0 0 0 0
0 0 10 0 0 11 0 2 0 0 15 15 0
0 3 0 0 10 0 0 0 6 0 0 1 0
0 0 0 6 0 0 0 0 0 0 0 0 0
0 0 0 0 0 13 0 0 0 9 0 0 0
0 3 0 5 0 0 0 0 0 0 0 5 0
0 3 0 0 0 14 0 0 0 0 0 8 0
0 0 0 13 0 0 0 0 0 0 0 3 0
0 0 0 0 0 0 0 13 0 1 0 0 0
0 2 0 0 0 0 0 0 0 0 0 4 0
0 1 0 4 0 12 0 0 0 0 0 0 0
0 0 0 12 0 0 0 0 0 0 0 0 0
0 11 0 0 0 0 0 0 0 0 0 0 0
0 0 0 0 0 0 0 0 0 0 0 0 0
0 1 0 0 0 0 0 0 0 0 0 0 0
0 0 0 0 0 0 0 0 0 0 0 0 0
