11
17
1
1
0
0
0
0
3
3
5
30
15
10 10 10 10 10 10 10 10 10 10 10
10 10 10 10 10 10 10 10 10 10 10
7 10 10 0 0 0 0 0 10 10 7
9 10 10 11 11 11 11 11 10 10 9
9 10 10 10 6 11 4 10 10 10 9
9 10 10 10 6 11 4 10 10 10 9
9 10 10 10 6 11 4 10 10 10 9
9 5 5 10 6 11 4 10 5 5 9
9 9 9 10 6 11 4 10 9 9 9
9 3 3 10 6 11 4 10 3 3 9
9 10 10 10 6 11 4 10 10 10 9
9 10 10 10 6 11 4 10 10 10 9
9 10 10 11 11 11 11 11 10 10 9
9 10 10 10 10 10 10 10 10 10 9
9 10 10 10 10 10 10 10 10 10 9
9 10 10 10 10 10 10 10 10 10 9
9 9 9 9 2 2 2 9 9 9 9
0 0 0 0 0 0 0 0 0 0 0
0 0 0 0 0 0 0 0 0 0 0
0 0 0 0 0 2 0 0 0 0 0
0 0 0 0 0 0 0 0 0 0 0
0 0 0 0 0 0 0 0 0 0 0
0 0 0 0 0 0 0 0 0 0 0
0 0 0 0 0 0 0 0 0 0 0
0 0 0 0 0 0 2 0 0 0 0
0 0 0 0 0 0 0 0 0 0 0
0 0 2 0 0 0 3 0 0 1 0
0 0 0 0 0 0 0 0 0 0 0
0 0 0 0 0 0 0 0 0 0 0
0 0 0 0 0 0 0 0 0 0 0
0 0 0 0 0 0 0 0 0 0 0
0 0 0 0 0 0 0 0 0 0 0
0 0 0 0 0 0 0 0 0 0 0
0 0 0 0 3 0 0 0 0 0 0
0 0 0 0 0 0 0 0 0 0 0
0 0 0 0 0 0 0 0 0 0 0
0 0 0 0 0 3 0 0 0 0 0
0 0 0 0 0 0 0 0 0 0 0
0 0 0 0 0 0 0 0 0 0 0
0 0 0 0 0 0 0 0 0 0 0
0 0 0 0 0 0 0 0 0 0 0
0 0 0 0 0 0 4 0 0 0 0
0 0 0 0 0 0 0 0 0 0 0
0 0 3 0 0 0 0 0 0 13 0
0 0 0 0 0 0 0 0 0 0 0
0 0 0 0 0 0 0 0 0 0 0
0 0 0 0 0 0 0 0 0 0 0
0 0 0 0 0 0 0 0 0 0 0
0 0 0 0 0 0 0 0 0 0 0
0 0 0 0 0 0 0 0 0 0 0
0 0 0 0 12 0 0 0 0 0 0
