11
17
0
0
0
0
0
0
1
0
5
30
15
9 18 9 18 9 18 9 18 9 18 9
9 18 9 10 9 10 9 10 9 10 9
9 10 9 10 9 3 9 10 9 10 9
9 10 9 2 9 3 9 2 9 10 9
9 0 9 2 9 3 9 2 9 0 9
9 10 9 18 9 10 9 18 9 18 9
9 10 9 10 9 10 9 10 9 10 9
9 10 9 10 9 10 9 10 9 10 9
9 10 9 10 9 18 9 10 9 10 9
9 10 9 10 9 10 9 10 9 10 9
9 0 9 2 9 3 9 2 9 0 9
9 0 9 2 9 3 9 2 9 0 9
9 10 9 10 9 3 9 10 9 10 9
9 10 9 10 9 10 9 10 9 10 9
9 12 9 12 9 12 9 12 9 12 9
9 9 9 9 9 9 9 9 9 9 9
9 12 9 12 9 12 9 12 9 12 9
0 0 0 0 0 0 0 0 0 0 0
0 0 0 0 0 0 0 0 0 0 0
0 0 0 0 0 0 0 0 0 0 0
0 4 0 2 0 2 0 0 0 2 0
0 0 0 3 0 0 0 0 0 2 0
0 0 0 1 0 2 0 0 0 0 0
0 0 0 0 0 0 0 0 0 0 0
0 0 0 0 0 0 0 0 0 0 0
0 0 0 0 0 0 0 0 0 0 0
0 0 0 0 0 0 0 0 0 0 0
0 2 0 0 0 0 0 0 0 1 0
0 0 0 0 0 2 0 0 0 0 0
0 0 0 0 0 0 0 0 0 0 0
0 0 0 0 0 0 0 0 0 0 0
0 0 0 0 0 0 0 0 0 0 0
0 0 0 0 0 0 0 0 0 0 0
0 0 0 0 0 0 0 0 0 0 0
0 0 0 0 0 0 0 0 0 0 0
0 0 0 0 0 0 0 0 0 0 0
0 0 0 0 0 0 0 0 0 0 0
0 3 0 5 0 0 0 0 0 0 0
0 0 0 0 0 0 0 0 0 12 0
0 0 0 0 0 3 0 0 0 0 0
0 0 0 0 0 0 0 0 0 0 0
0 0 0 0 0 0 0 0 0 0 0
0 0 0 0 0 0 0 0 0 0 0
0 0 0 0 0 0 0 0 0 0 0
0 3 0 0 0 0 0 0 0 0 0
0 0 0 0 0 3 0 0 0 0 0
0 0 0 0 0 0 0 0 0 0 0
0 0 0 0 0 0 0 0 0 0 0
0 0 0 0 0 0 0 0 0 0 0
0 0 0 0 0 0 0 0 0 0 0
0 0 0 0 0 0 0 0 0 0 0
