11
17
1
1
1
1
1
1
7
0
5
15
30
10 10 10 10 10 10 10 10 10 10 10
10 10 10 10 10 10 10 10 10 10 10
10 10 10 10 10 10 10 10 10 10 10
10 10 10 10 10 10 10 10 10 10 10
10 10 10 10 10 10 10 10 10 10 10
10 10 10 10 10 10 10 10 10 10 10
10 10 10 7 7 7 7 7 10 10 10
10 7 7 5 5 5 5 5 7 7 10
7 9 5 9 3 3 3 9 5 9 7
9 5 9 3 2 2 2 3 9 5 9
5 10 3 2 10 10 10 2 3 10 5
8 3 2 10 10 10 10 10 2 3 8
3 8 2 10 10 10 10 10 2 8 3
3 2 8 8 10 10 10 8 8 2 3
10 2 10 10 8 8 8 10 10 2 10
2 10 10 10 10 10 10 10 10 10 2
2 10 10 10 10 10 10 10 10 10 2
0 0 0 0 0 0 0 0 0 0 0
0 0 0 0 0 0 0 0 0 0 0
0 0 0 0 0 0 0 0 0 0 0
0 0 0 0 0 0 0 0 0 0 0
0 0 0 0 0 0 0 0 0 0 0
0 0 0 0 0 0 0 0 0 0 0
0 0 0 0 0 0 0 0 0 0 0
0 0 0 0 0 0 0 0 0 0 0
0 0 0 0 2 0 1 0 0 0 0
0 0 0 0 0 3 0 0 0 0 0
0 0 2 0 0 0 0 0 0 0 0
0 0 0 0 0 0 0 0 0 0 0
0 1 0 0 0 0 0 0 0 3 0
0 0 1 0 0 0 0 0 0 0 3
0 0 0 0 0 0 0 0 0 0 0
0 0 0 0 0 0 0 0 0 0 0
0 0 0 0 0 0 0 0 0 0 0
0 0 0 0 0 0 0 0 0 0 0
0 0 0 0 0 0 0 0 0 0 0
0 0 0 0 0 0 0 0 0 0 0
0 0 0 0 0 0 0 0 0 0 0
0 0 0 0 0 0 0 0 0 0 0
0 0 0 0 0 0 0 0 0 0 0
0 0 0 0 0 0 0 0 0 0 0
0 0 0 0 0 0 0 0 0 0 0
0 0 0 0 4 0 2 0 0 0 0
0 0 0 0 0 15 0 0 0 0 0
0 0 10 0 0 0 0 0 0 0 0
0 0 0 0 0 0 0 0 0 0 0
0 9 0 0 0 0 0 0 0 13 0
0 0 6 0 0 0 0 0 0 0 0
0 0 0 0 0 0 0 0 0 0 0
0 0 0 0 0 0 0 0 0 0 0
0 0 0 0 0 0 0 0 0 0 0
