11
17
0
1
1
0
0
0
5
0
5
30
15
10 10 10 10 10 10 10 10 10 10 10
10 10 4 10 10 10 10 10 10 10 10
10 10 4 4 10 10 10 10 10 10 10
4 4 16 4 10 10 10 10 10 10 10
4 16 16 16 4 10 10 10 10 10 10
4 16 16 16 4 4 10 10 4 4 4
4 16 4 16 16 4 4 4 16 16 4
4 16 4 16 16 4 16 16 16 16 4
4 16 4 16 4 16 16 16 16 4 10
4 16 16 16 4 16 16 16 16 4 10
4 3 3 4 10 4 3 3 4 10 10
4 6 6 4 10 4 6 6 4 10 10
4 0 4 10 4 0 0 0 4 4 10
4 0 4 10 4 0 0 0 0 4 10
4 4 10 4 0 0 4 4 0 0 4
4 4 10 4 0 4 4 10 4 0 4
4 10 10 4 4 4 10 10 10 4 4
0 0 0 0 0 0 0 0 0 0 0
0 0 0 0 0 0 0 0 0 0 0
0 0 0 0 0 0 0 0 0 0 0
0 0 0 0 0 0 0 0 0 0 0
0 0 0 0 0 0 0 0 0 0 0
0 0 0 0 0 0 0 0 0 0 0
0 0 0 0 1 0 0 0 0 0 0
0 0 2 0 1 1 0 0 0 0 0
0 0 0 0 0 0 0 0 0 0 0
0 0 0 0 0 0 0 0 0 0 0
0 0 0 0 0 0 0 4 0 0 0
0 0 0 0 0 0 0 0 0 0 0
1 0 1 0 0 2 0 3 0 0 0
0 0 0 0 0 0 0 0 0 0 0
1 0 0 0 0 0 0 0 0 0 0
0 0 0 0 0 0 0 0 0 0 0
0 0 0 0 0 0 0 0 0 0 0
0 0 0 0 0 0 0 0 0 0 0
0 0 0 0 0 0 0 0 0 0 0
0 0 0 0 0 0 0 0 0 0 0
0 0 0 0 0 0 0 0 0 0 0
0 0 0 0 0 0 0 0 0 0 0
0 0 0 0 0 0 0 0 0 0 0
0 0 0 0 2 0 0 0 0 0 0
0 0 2 0 1 14 0 0 0 0 0
0 0 0 0 0 0 0 0 0 0 0
0 0 0 0 0 0 0 0 0 0 0
0 0 0 0 0 0 0 4 0 0 0
0 0 0 0 0 0 0 0 0 0 0
4 0 6 0 0 13 0 3 0 0 0
0 0 0 0 0 0 0 0 0 0 0
14 0 0 0 0 0 0 0 0 0 0
0 0 0 0 0 0 0 0 0 0 0
0 0 0 0 0 0 0 0 0 0 0
