11
17
1
1
1
1
1
1
10
0
5
30
15
10 10 10 10 10 10 10 10 10 10 10
10 10 10 10 10 10 10 10 10 10 10
10 10 10 10 10 10 10 10 10 10 10
10 10 10 10 10 10 10 10 10 10 10
10 10 10 10 10 10 10 10 10 10 10
16 16 9 0 5 0 4 0 9 16 16
8 8 9 5 0 4 0 3 9 8 8
7 7 9 0 4 0 3 0 9 7 7
6 6 9 4 0 3 0 2 9 6 6
5 5 9 0 3 0 2 0 9 5 5
4 4 9 3 0 2 0 5 9 4 4
3 3 9 0 2 0 5 0 9 3 3
2 2 9 2 0 5 0 4 9 2 2
1 1 9 0 5 0 4 0 9 1 1
0 0 9 9 9 9 9 9 9 0 0
10 10 10 10 10 10 10 10 10 10 10
10 10 10 10 10 10 10 10 10 10 10
0 0 0 0 0 0 0 0 0 0 0
0 0 0 0 0 0 0 0 0 0 0
0 0 0 0 0 0 0 0 0 0 0
0 0 0 0 0 0 0 0 0 0 0
0 0 0 0 0 0 0 0 0 0 0
0 0 0 0 1 0 0 0 0 0 0
0 0 0 0 0 0 0 0 0 0 0
0 0 0 0 0 0 0 2 0 0 0
0 0 0 0 0 0 0 0 0 0 0
0 2 0 0 2 0 0 2 0 0 0
0 0 0 0 0 0 0 0 0 4 0
0 0 0 0 0 0 0 0 0 0 0
0 0 0 2 0 2 0 0 0 0 0
2 0 0 0 0 0 0 0 0 0 3
0 0 0 0 0 0 0 0 0 0 0
0 0 0 0 0 0 0 0 0 0 0
0 0 0 0 0 0 0 0 0 0 0
0 0 0 0 0 0 0 0 0 0 0
0 0 0 0 0 0 0 0 0 0 0
0 0 0 0 0 0 0 0 0 0 0
0 0 0 0 0 0 0 0 0 0 0
0 0 0 0 0 0 0 0 0 0 0
0 0 0 0 4 0 0 0 0 0 0
0 0 0 0 0 0 0 0 0 0 0
0 0 0 0 0 0 0 1 0 0 0
0 0 0 0 0 0 0 0 0 0 0
0 8 0 0 2 0 0 10 0 0 0
0 0 0 0 0 0 0 0 0 4 0
0 0 0 0 0 0 0 0 0 0 0
0 0 0 4 0 13 0 0 0 0 0
3 0 0 0 0 0 0 0 0 0 4
0 0 0 0 0 0 0 0 0 0 0
0 0 0 0 0 0 0 0 0 0 0
0 0 0 0 0 0 0 0 0 0 0
