11
17
0
0
1
0
1
0
4
1
5
15
30
10 10 10 10 10 10 10 10 10 10 10
10 0 0 0 3 3 3 0 0 0 10
10 19 19 19 19 3 19 19 19 19 10
10 4 4 4 19 3 19 4 4 4 10
10 4 7 7 19 3 19 7 7 4 10
10 4 7 17 19 3 19 17 7 4 10
10 3 0 8 8 3 8 8 0 3 10
10 0 3 0 0 3 0 0 3 0 10
10 0 0 3 3 3 3 3 0 0 10
10 10 0 0 0 3 0 0 0 10 10
10 10 0 19 4 19 4 19 0 10 10
10 10 0 19 4 19 4 19 0 10 10
10 10 0 19 4 19 4 19 0 10 10
10 10 0 19 19 19 19 19 0 10 10
10 10 10 0 0 0 0 0 10 10 10
10 10 10 10 10 10 10 10 10 10 10
10 10 10 10 10 10 10 10 10 10 10
0 0 0 0 0 0 0 0 0 0 0
0 3 1 0 1 0 0 4 0 4 0
0 2 0 0 0 0 0 0 0 0 0
0 2 0 0 0 0 0 0 0 0 0
0 0 0 0 0 0 0 0 0 0 0
0 0 0 0 0 0 0 0 0 0 0
0 0 0 0 0 0 0 0 0 0 0
0 0 1 2 0 2 0 0 3 2 0
0 0 0 0 0 0 0 0 0 0 0
0 0 0 3 0 2 0 2 1 0 0
0 0 2 0 0 0 0 0 0 0 0
0 0 0 0 0 0 0 0 0 0 0
0 0 0 0 0 0 0 0 0 0 0
0 0 3 0 0 0 0 0 0 0 0
0 0 0 0 3 0 0 2 0 0 0
0 0 0 0 0 0 0 0 0 0 0
0 0 0 0 0 0 0 0 0 0 0
0 0 0 0 0 0 0 0 0 0 0
0 3 0 0 0 0 0 3 0 4 0
0 4 0 0 0 0 0 0 0 0 0
0 15 0 0 0 0 0 0 0 0 0
0 0 0 0 0 0 0 0 0 0 0
0 0 0 0 0 0 0 0 0 0 0
0 0 0 0 0 0 0 0 0 0 0
0 0 12 4 0 0 0 0 8 6 0
0 0 0 0 0 0 0 0 0 0 0
0 0 0 13 0 14 0 4 10 0 0
0 0 0 0 0 0 0 0 0 0 0
0 0 0 0 0 0 0 0 0 0 0
0 0 0 0 0 0 0 0 0 0 0
0 0 13 0 0 0 0 0 0 0 0
0 0 0 0 3 0 0 12 1 0 0
0 0 0 0 0 0 0 0 0 0 0
0 0 0 0 0 0 0 0 0 0 0
