11
17
1
1
0
1
0
1
1
0
5
30
15
10 10 10 10 10 10 10 10 10 10 10
10 8 10 10 10 10 10 10 10 8 10
8 6 8 10 10 10 10 10 8 6 8
8 6 0 8 8 8 8 8 0 6 8
8 6 6 0 3 3 3 0 6 6 8
8 6 6 3 3 3 3 3 6 6 8
10 8 3 3 3 3 3 3 3 8 10
10 8 3 0 3 3 3 0 3 8 10
10 8 3 12 3 3 3 12 3 8 10
10 8 6 6 6 3 6 6 6 8 10
10 8 3 3 3 3 3 3 3 8 10
10 8 3 3 3 2 3 3 3 8 10
10 8 3 8 3 8 3 8 3 8 10
10 8 3 3 8 3 8 3 3 8 10
10 10 8 3 3 3 3 3 8 10 10
10 10 8 8 3 3 3 8 8 10 10
10 10 10 10 8 8 8 10 10 10 10
0 0 0 0 0 0 0 0 0 0 0
0 0 0 0 0 0 0 0 0 0 0
0 0 0 0 0 0 0 0 0 0 0
0 0 0 0 0 0 0 0 0 0 0
0 0 0 0 0 1 0 0 0 0 0
0 0 0 0 0 0 0 0 0 0 2
0 2 0 0 0 0 0 0 0 0 0
0 0 0 0 0 0 0 0 0 0 0
0 0 0 0 0 0 0 0 0 1 0
0 0 2 0 0 0 0 0 0 0 0
0 0 0 0 0 0 0 0 0 0 0
0 0 0 0 0 0 0 0 0 0 0
0 2 0 0 0 0 0 0 1 0 0
0 0 0 0 0 0 0 0 0 0 0
0 0 0 0 0 0 0 0 0 0 0
0 0 0 0 0 0 0 0 0 0 0
0 0 0 0 0 0 0 0 0 0 0
0 0 0 0 0 0 0 0 0 0 0
0 0 0 0 0 0 0 0 0 0 0
0 0 0 0 0 0 0 0 0 0 0
0 0 0 0 0 0 0 0 0 0 0
0 0 0 0 0 9 0 0 0 0 0
0 0 0 0 0 0 0 0 0 0 2
0 4 0 0 0 0 0 0 0 0 0
0 0 0 0 0 0 0 0 0 0 0
0 0 0 0 0 0 0 0 0 2 0
0 0 3 0 0 0 0 0 0 0 0
0 0 0 0 0 0 0 0 0 0 0
0 0 0 0 0 0 0 0 0 0 0
0 10 0 0 0 0 0 0 4 0 0
0 0 0 0 0 0 0 0 0 0 0
0 0 0 0 0 0 0 0 0 0 0
0 0 0 0 0 0 0 0 0 0 0
0 0 0 0 0 0 0 0 0 0 0
