11
17
1
1
1
0
1
0
12
1
3
15
30
10 10 10 10 10 10 10 10 10 10 10
10 10 10 10 10 10 10 10 10 10 10
10 10 10 10 10 10 10 10 10 10 10
10 10 10 10 10 10 10 10 10 10 10
8 11 8 11 9 10 9 11 8 11 8
3 3 3 3 9 10 9 3 3 3 3
3 7 7 7 9 10 9 7 7 7 3
3 7 0 0 9 10 9 0 0 7 3
3 7 0 12 9 10 9 12 0 7 3
9 9 9 9 9 10 9 9 9 9 9
12 2 2 2 2 10 2 2 2 2 12
9 9 9 9 9 10 9 9 9 9 9
6 5 0 12 9 10 9 12 0 5 6
6 5 0 0 9 10 9 0 0 5 6
6 5 5 5 9 10 9 5 5 5 6
6 6 6 6 9 10 9 6 6 6 6
11 11 11 11 9 10 9 11 11 11 11
0 0 0 0 0 0 0 0 0 0 0
0 0 0 0 0 0 0 0 0 0 0
0 0 0 0 0 0 0 0 0 0 0
0 0 0 0 0 0 0 0 0 0 0
0 0 0 0 0 0 0 0 0 0 0
4 0 0 1 0 0 0 2 0 0 0
0 0 0 0 0 0 0 0 0 0 0
3 0 0 0 0 0 0 0 0 0 0
0 0 0 0 0 0 0 0 0 0 0
0 0 0 0 0 0 0 0 0 0 0
0 0 0 0 1 0 1 0 0 0 0
0 0 0 0 0 0 0 0 0 0 0
0 0 1 0 0 0 0 0 0 0 0
1 0 3 0 0 0 0 0 2 0 0
0 0 0 0 0 0 0 0 0 0 0
0 1 0 0 0 0 0 0 0 0 3
4 4 6 5 0 0 0 3 4 5 5
0 0 0 0 0 0 0 0 0 0 0
0 0 0 0 0 0 0 0 0 0 0
0 0 0 0 0 0 0 0 0 0 0
0 0 0 0 0 0 0 0 0 0 0
0 0 0 0 0 0 0 0 0 0 0
5 0 0 4 0 0 0 4 0 0 0
0 0 0 0 0 0 0 0 0 0 0
12 0 0 0 0 0 0 0 0 0 0
0 0 0 0 0 0 0 0 0 0 0
0 0 0 0 0 0 0 0 0 0 0
0 0 0 0 8 0 10 0 0 0 0
0 0 0 0 0 0 0 0 0 0 0
0 0 9 0 0 0 0 0 0 0 0
7 0 4 0 0 0 0 0 2 0 0
0 0 0 0 0 0 0 0 0 0 0
0 6 0 0 0 0 0 0 0 0 12
4 3 2 1 0 0 0 4 3 3 4
