11
17
1
1
0
1
0
1
13
1
5
30
15
10 10 10 10 10 10 10 10 10 10 10
10 10 10 10 10 10 10 10 10 10 10
10 10 10 10 10 10 10 10 10 10 10
10 10 10 4 10 10 10 4 10 10 10
10 10 4 0 4 10 4 0 4 10 10
10 4 0 2 0 8 0 2 0 4 10
10 4 0 2 2 4 8 2 0 4 10
4 0 2 2 4 8 4 2 2 0 4
4 2 2 4 8 4 4 4 2 2 4
4 2 4 4 4 8 4 4 4 2 4
4 4 4 4 4 4 8 4 4 4 4
10 4 4 4 4 8 4 4 4 4 10
10 4 4 4 8 4 4 4 4 4 10
10 10 4 4 4 8 4 4 4 10 10
10 10 10 4 4 4 8 4 10 10 10
10 10 10 10 4 8 4 10 10 10 10
10 10 10 10 10 4 10 10 10 10 10
0 0 0 0 0 0 0 0 0 0 0
0 0 0 0 0 0 0 0 0 0 0
0 0 0 0 0 0 0 0 0 0 0
0 0 0 0 0 0 0 0 0 0 0
0 0 0 0 0 0 0 0 0 0 0
0 0 0 0 0 0 0 0 0 0 0
0 0 0 0 2 0 0 0 0 0 0
0 0 0 0 0 0 0 0 0 0 0
0 0 0 0 0 0 0 0 1 0 0
0 0 0 0 0 0 2 0 0 0 3
0 0 2 0 0 0 0 0 0 0 0
0 0 0 0 0 0 0 0 1 0 0
0 1 0 0 0 0 0 0 0 0 0
0 0 0 2 0 0 0 0 0 0 0
0 0 0 0 0 0 0 3 0 0 0
0 0 0 0 0 0 0 0 0 0 0
0 0 0 0 0 0 0 0 0 0 0
0 0 0 0 0 0 0 0 0 0 0
0 0 0 0 0 0 0 0 0 0 0
0 0 0 0 0 0 0 0 0 0 0
0 0 0 0 0 0 0 0 0 0 0
0 0 0 0 0 0 0 0 0 0 0
0 0 0 0 0 0 0 0 0 0 0
0 0 0 0 5 0 0 0 0 0 0
0 0 0 0 0 0 0 0 0 0 0
0 0 0 0 0 0 0 0 6 0 0
0 0 0 0 0 0 4 0 0 0 15
0 0 12 0 0 0 0 0 0 0 0
0 0 0 0 0 0 0 0 14 0 0
0 9 0 0 0 0 0 0 0 0 0
0 0 0 4 0 0 0 0 0 0 0
0 0 0 0 0 0 0 4 0 0 0
0 0 0 0 0 0 0 0 0 0 0
0 0 0 0 0 0 0 0 0 0 0
