11
17
1
1
0
0
0
0
1
0
5
15
30
10 10 10 10 10 10 10 10 10 10 10
10 10 10 10 10 10 10 10 10 10 10
10 10 10 10 1 1 1 10 10 10 10
10 10 1 1 7 7 7 1 1 10 10
10 1 7 7 7 7 7 7 7 1 10
10 1 7 0 0 7 7 7 0 0 10
1 7 0 0 0 0 7 0 0 0 0
1 7 0 0 0 0 7 0 0 0 0
1 7 0 0 8 8 7 0 0 8 8
1 7 0 0 8 12 7 0 0 8 12
1 7 7 0 0 7 7 7 0 0 1
1 7 7 7 7 7 7 7 7 7 1
1 7 7 7 7 7 7 7 7 7 1
1 7 7 7 7 7 7 7 7 7 1
1 7 7 1 7 7 7 7 1 7 1
1 7 1 10 1 7 7 1 10 1 1
1 1 10 10 10 1 1 10 10 10 1
0 0 0 0 0 0 0 0 0 0 0
0 0 0 0 0 0 0 0 0 0 0
0 0 0 0 0 0 0 0 0 0 0
0 0 0 0 0 0 0 0 0 0 0
0 0 0 0 0 3 0 0 0 0 0
0 0 0 0 0 0 0 0 0 0 0
0 1 0 0 0 0 0 0 0 0 0
0 0 0 0 0 0 0 0 0 0 0
0 0 0 0 0 0 0 0 1 0 0
0 0 0 0 0 0 0 0 0 0 0
0 2 0 0 0 0 0 0 0 0 0
0 0 0 0 0 0 0 0 0 0 0
0 0 0 0 0 0 0 0 2 0 0
0 0 0 0 1 0 0 0 0 0 0
0 0 0 0 0 0 0 0 0 0 0
0 1 0 0 0 0 2 0 0 0 0
0 1 0 0 0 0 0 0 0 0 0
0 0 0 0 0 0 0 0 0 0 0
0 0 0 0 0 0 0 0 0 0 0
0 0 0 0 0 0 0 0 0 0 0
0 0 0 0 0 0 0 0 0 0 0
0 0 0 0 0 13 0 0 0 0 0
0 0 0 0 0 0 0 0 0 0 0
0 6 0 0 0 0 0 0 0 0 0
0 0 0 0 0 0 0 0 0 0 0
0 0 0 0 0 0 0 0 13 0 0
0 0 0 0 0 0 0 0 0 0 0
0 13 0 0 0 0 0 0 0 0 0
0 0 0 0 0 0 0 0 0 0 0
0 0 0 0 0 0 0 0 15 0 0
0 0 0 0 11 0 0 0 0 0 0
0 0 0 0 0 0 0 0 0 0 0
0 0 0 0 0 0 12 0 0 0 0
0 9 0 0 0 0 0 0 0 0 0
