11
17
1
1
0
0
0
1
11
1
5
30
15
10 10 10 10 10 10 10 10 10 10 10
10 10 10 10 10 10 10 10 10 10 10
10 10 10 10 10 10 10 10 10 10 10
10 10 10 10 10 10 10 10 10 10 10
10 10 10 10 10 10 10 10 10 10 10
0 0 0 10 10 10 10 10 10 10 10
2 2 2 0 0 10 10 10 10 10 0
4 4 4 2 2 0 0 10 10 0 16
8 8 8 4 4 2 2 0 0 16 16
17 17 17 8 8 4 16 2 16 16 2
10 10 10 17 17 8 4 16 2 2 16
10 10 10 10 10 17 8 4 16 16 4
10 10 10 10 10 17 8 16 4 4 16
10 10 10 10 10 10 17 8 16 16 16
10 10 10 10 10 10 17 8 16 16 8
10 10 10 10 10 10 10 17 8 8 17
10 10 10 10 10 10 10 10 17 17 10
0 0 0 0 0 0 0 0 0 0 0
0 0 0 0 0 0 0 0 0 0 0
0 0 0 0 0 0 0 0 0 0 0
0 0 0 0 0 0 0 0 0 0 0
0 0 0 0 0 0 0 0 0 0 0
3 0 0 0 0 0 0 0 0 0 0
0 0 0 0 0 0 0 0 0 0 1
0 0 5 0 0 0 0 0 0 0 0
1 0 0 0 0 0 3 0 0 0 0
0 0 0 0 0 0 0 0 0 0 0
0 0 0 4 0 0 0 1 0 0 0
0 0 0 0 0 3 0 3 2 2 1
0 0 0 0 0 0 0 0 0 0 0
0 0 0 0 0 0 0 0 0 0 0
0 0 0 0 0 0 0 0 0 0 0
0 0 0 0 0 0 0 0 0 0 0
0 0 0 0 0 0 0 0 0 0 0
0 0 0 0 0 0 0 0 0 0 0
0 0 0 0 0 0 0 0 0 0 0
0 0 0 0 0 0 0 0 0 0 0
0 0 0 0 0 0 0 0 0 0 0
0 0 0 0 0 0 0 0 0 0 0
13 0 0 0 0 0 0 0 0 0 0
0 0 0 0 0 0 0 0 0 0 2
0 0 13 0 0 0 0 0 0 0 0
10 0 0 0 0 0 2 0 0 0 0
0 0 0 0 0 0 0 0 0 0 0
0 0 0 13 0 0 0 3 0 0 0
0 0 0 0 0 12 0 2 1 5 4
0 0 0 0 0 0 0 0 0 0 0
0 0 0 0 0 0 0 0 0 0 0
0 0 0 0 0 0 0 0 0 0 0
0 0 0 0 0 0 0 0 0 0 0
0 0 0 0 0 0 0 0 0 0 0
