11
17
1
1
0
0
0
0
3
3
5
15
30
10 10 10 10 10 10 10 10 10 10 10
10 10 10 10 10 10 10 10 10 10 10
10 10 10 10 10 10 10 10 10 10 10
10 10 10 10 10 10 10 10 10 10 10
10 10 10 10 10 10 10 10 10 10 10
11 6 6 6 6 6 6 6 6 6 11
4 11 6 6 6 6 6 6 6 11 5
4 4 11 6 6 6 6 6 11 5 5
4 4 4 11 6 6 6 11 5 5 5
4 4 4 4 11 6 11 5 5 5 5
4 4 4 4 4 11 5 5 5 5 5
4 4 4 4 11 7 11 5 5 5 5
4 4 4 11 7 7 7 11 5 5 5
4 4 11 7 7 7 7 7 11 5 5
4 11 7 7 7 7 7 7 7 11 5
11 7 7 7 7 7 7 7 7 7 11
10 10 10 10 10 10 10 10 10 10 10
0 0 0 0 0 0 0 0 0 0 0
0 0 0 0 0 0 0 0 0 0 0
0 0 0 0 0 0 0 0 0 0 0
0 0 0 0 0 0 0 0 0 0 0
0 0 0 0 0 0 0 0 0 0 0
0 2 0 0 0 0 0 0 0 0 0
0 0 0 0 0 0 1 0 0 0 0
0 0 0 0 1 0 0 0 0 0 0
0 0 0 0 0 0 0 0 0 0 2
0 0 0 0 0 0 0 0 0 0 0
0 1 0 0 0 0 0 0 2 0 0
0 0 0 0 0 0 0 0 0 0 0
0 0 0 0 0 0 0 0 0 0 0
0 0 0 0 0 0 0 0 0 0 0
0 0 0 0 2 2 0 0 0 0 0
0 0 1 0 0 0 4 0 0 0 0
0 0 0 0 0 0 0 0 0 0 0
0 0 0 0 0 0 0 0 0 0 0
0 0 0 0 0 0 0 0 0 0 0
0 0 0 0 0 0 0 0 0 0 0
0 0 0 0 0 0 0 0 0 0 0
0 0 0 0 0 0 0 0 0 0 0
0 9 0 0 0 0 0 0 0 0 0
0 0 0 0 3 0 3 0 0 0 0
0 0 0 0 0 0 0 0 0 0 0
0 0 0 0 0 0 0 0 0 0 8
0 0 0 0 0 0 0 0 0 0 0
0 2 0 0 0 0 0 0 4 0 0
0 0 0 0 0 0 0 0 0 0 0
0 0 0 0 0 0 0 0 0 0 0
0 0 0 0 0 0 0 0 0 0 0
0 0 0 0 3 0 0 0 0 0 0
0 0 9 0 0 0 4 0 0 0 0
0 0 0 0 0 0 0 0 0 0 0
