11
17
1
1
0
0
0
0
15
1
5
30
15
10 10 10 10 10 10 10 10 10 10 10
10 10 10 10 10 10 10 10 10 10 10
11 11 10 10 10 10 10 10 10 11 11
0 0 11 11 10 10 10 11 11 0 0
2 2 0 0 11 10 11 0 0 2 2
4 4 2 2 0 11 0 2 2 4 4
4 4 2 2 0 11 0 2 2 4 4
2 2 0 0 11 10 11 0 0 2 2
0 0 11 11 10 10 10 11 11 0 0
11 11 10 10 10 10 10 10 10 11 11
0 0 11 11 10 10 10 11 11 0 0
2 2 0 0 11 10 11 0 0 2 2
4 4 2 2 0 11 0 2 2 4 4
4 4 2 2 0 11 0 2 2 4 4
2 2 0 0 11 10 11 0 0 2 2
0 0 11 11 10 10 10 11 11 0 0
11 11 10 10 10 10 10 10 10 11 11
0 0 0 0 0 0 0 0 0 0 0
0 0 0 0 0 0 0 0 0 0 0
0 0 0 0 0 0 0 0 0 0 0
0 0 0 0 0 0 0 0 0 0 0
0 0 0 0 0 0 0 0 0 0 0
0 1 0 0 0 0 2 0 0 2 2
0 0 0 1 0 0 0 0 2 0 0
0 0 0 0 0 0 0 0 0 0 0
0 0 0 0 0 0 0 0 0 0 0
0 0 0 0 0 0 0 0 0 0 0
0 0 0 3 0 0 0 2 0 0 0
1 0 0 0 0 0 0 0 0 0 0
0 0 0 0 0 0 0 0 0 0 2
0 0 3 1 0 5 0 0 2 0 0
0 0 0 0 0 0 0 0 0 0 0
0 0 0 0 0 0 0 0 0 0 0
0 4 0 0 0 0 0 0 0 0 0
0 0 0 0 0 0 0 0 0 0 0
0 0 0 0 0 0 0 0 0 0 0
0 0 0 0 0 0 0 0 0 0 0
0 0 0 0 0 0 0 0 0 0 0
0 0 0 0 0 0 0 0 0 0 0
0 6 0 0 0 0 4 0 0 2 1
0 0 0 3 0 0 0 0 13 0 0
0 0 0 0 0 0 0 0 0 0 0
0 0 0 0 0 0 0 0 0 0 0
0 0 0 0 0 0 0 0 0 0 0
0 0 0 4 0 0 0 3 0 0 0
10 0 0 0 0 0 0 0 0 0 0
0 0 0 0 0 0 0 0 0 0 12
0 0 2 0 0 13 0 0 2 0 0
0 0 0 0 0 0 0 0 0 0 0
0 0 0 0 0 0 0 0 0 0 0
0 4 0 0 0 0 0 0 0 0 0
